尉|健行
蕩|妹|婦|女
放|荡熟女|蕩少婦|盘|光明制作中心|荡少妇|荡少妇宾馆|账|下执着|火|蕩熟女|蕩少婦賓館|尿|蕩|贷款
他|媽的|马的|吗的|妈|爹|奶奶的|媽|娘|妈的|祖宗|妈的靠|nnd|嗎的|母親|母亲
援|交自拍|交薄码|交全套服务|交妹|藏|交女上门服务|助交易|交|交薄碼|交妹妹|交上门|助交际|交信息|交俱乐部
云|雨
旭|日|日厂
讲|法
弗|雷迪
卖|真实一代身份证|真实一代身份證|二代個人身份證|双管獵qiang出售|白牙簽qq|大冰磚手机|迷魂粉电话|进口汽狗|国|1代高仿身份证|一代假身份證|鉆石冰qq|迷魂粉qq|黃牙簽电话|54式64式|乌头碱|壹代精仿身份证|二代精仿身份证|真壹代身份证|高压气枪|党求荣|氰化钾|个人一代身份证|神仙水qq|冰磚qq|大冰磚qq|奶油冰电话|眼角膜qq|奶油冰qq|奶油冰手机|硝酸铊|小冰砖手机|黄体酮手机|cfx气枪|二代高仿身份证|1代精仿身份证|假冒壹代身份證|king粉手机|钻石冰qq|工字牌汽枪|2代個人身份证|個人2代身份证|个人壹代身份证|假壹代身份證|k粉qq|左旋麻黄素手机|钻石冰手机|冰毒电话|high粉电话|麥角酸电话|2代假身份证|假冒1代身份證|盐酸羟亚胺qq|肾qq|号|個人一代身份证|麻谷手机|间苯三酚电话|肾信息|假二代身份证|假1代身份證|仿真手槍|k粉|壹代假身份证|間苯三酚qq|甲卡西酮qq|青蒿素电话|甲卡西酮电话|迷魂药电话|枪支弹药|藏刀|真实1代身份證|一代個人身份證|壹代高仿身份證|摇头丸电话|假壹代身份证|壹代假冒身份證|2代精仿身份證|一代高仿身份證|白牙簽电话|钢珠槍|水果冰|钢珠枪qq|假冒2代身份证|真2代身份證|high粉qq|神仙糖qq|白牙簽手机|真实2代身份证|一代精仿身份证|三唑侖qq|冰毒qq|黄牙签电话|猎枪|1代高仿身份證|神仙水电话|胡椒基甲酮电话|铊盐|腎臟qq|冰钻qq|小冰砖qq|摇头丸手机|白牙签电话|神仙糖电话|迷魂水电话|1代假冒身份證|个人一代身份證|麥角酸qq|麻黄素qq|水果冰qq|氰化钙|真二代身份证|黄牙签手机|甲卡西酮手机|骚|三唑仑片|個人1代身份证|壹代高仿身份证|摇头糖qq|氯胺酮电话|眼角膜|一代高仿身份证|二代假冒身份證|2代假冒身份证|二代個人身份证|个人1代身份证|2代假身份證|迷魂药手机|鹽酸羥亞胺电话|海洛因|水晶冰|二代假身份证|1代假身份證|身份證生成器|真1代身份證|個人2代身份證|迷魂藥电话|肝臟qq|個人一代身份證|青蒿素qq|黃體酮qq|摇头丸qq|三唑侖手机|b|财富|1代假身份证|麻黃素手机|2代高仿身份證|個人二代身份證|冰砖手机|白粉手机|k粉电话|真实二代身份證|真实壹代身份證|個人壹代身份證|左旋麻黃素qq|搖頭糖手机|三箭牌气槍|一代假身份证|個人二代身份证|壹代假身份證|2代假冒身份證|盐酸羟亚胺手机|广州三箭气|真2代身份证|假一代身份證|一代假冒身份證|摇头糖手机|左旋麻黃素手机|神仙糖手机|春|假冒身份证|二代高仿身份證|麻古电话|单管獵槍出售|大冰砖手机|冰鉆石手机|钻石冰电话|热武器|假发票|1代假冒身份证|1代個人身份證|冰砖qq|king粉qq|冰鉆石qq|麦角酸手机|間苯三酚电话|肝源qq|壹代個人身份證|真实2代身份證|白粉电话|左轮手枪|软件|假币qq|一代個人身份证|真身份證|鉆石冰电话|淫|白牙签qq|.国|肝脏qq|假二代身份證|黄牙签qq|迷魂藥qq|迷魂藥手机|卡|砒霜|二代假冒身份证|1代個人身份证|大冰砖电话|健卫小口径|假一代身份证|真一代身份证|麻黃素qq|一代精仿身份證|盐酸羟亚胺电话|摇头糖电话|2代精仿身份证|鉆石qq|胡椒基甲酮qq|迷魂药qq|小冰砖电话|假2代身份證|个人2代身份證|麦角酸qq|搖頭丸qq|海洛因电话|冰毒手机|氯胺酮手机|冰磚电话|银行卡|国求荣|真实壹代身份证|假冒2代身份證|二代精仿身份證|壹代精仿身份證|麻黄素手机|白牙签手机|麻古手机|枪|身份证生成器|2代高仿身份证|1代精仿身份證|单管獵狗出售|氯胺酮qq|high粉手机|手铐|id|腎源qq|真实1代身份证|假身份證|麻谷qq|麻黃素电话|迷魂药三唑仑|金钟气枪|角膜qq|假冒1代身份证|一代假冒身份证|胡椒基甲酮手机|麦角酸电话|鉆石冰手机|仿真枪模|个人壹代身份證|乙醚qq|逼|假冒身份證|冰钻手机|間苯三酚手机|搖頭糖电话|手机窃听软件|假冒一代身份证|假冒二代身份证|白粉qq|黄体酮qq|海洛因手机|qq|麻古qq|麻黄素电话|假币|45mm狗粮|二代真实身份证|個人壹代身份证|真一代身份證|肾网|二代假身份證|個人1代身份證|真实身份证|真壹代身份證|搖頭丸电话|左旋麻黄素qq|小冰磚电话|假冒二代身份證|青蒿素手机|鹽酸羥亞胺手机|小冰磚手机|迷魂粉手机|虎头双管|壹代個人身份证|真身份证|个人二代身份證|大冰砖qq|迷魂水qq|乙醚电话|个人二代身份证|个人2代身份证|个人1代身份證|k粉手机|黃體酮手机|冰鉆石电话|king粉电话|假冒壹代身份证|假身份证|假冒一代身份證|真二代身份證|2代個人身份證|间苯三酚qq|海洛因qq|神仙水手机|搖頭糖qq|乙醚手机|间苯三酚手机|肾脏qq|假2代身份证|假1代身份证|水果冰手机|搖頭丸手机|迷魂水手机|冰钻电话|冰砖电话|铅弹气枪|手枪|小冰磚qq|黃牙簽qq|麻谷电话|胡椒基甲酮|秃鹰汽枪|壹代假冒身份证|真实二代身份证|鹽酸羥亞胺qq|比|真1代身份证|真实身份證|三唑侖电话|黃牙簽手机|麥角酸手机|新版假币|左旋麻黄素电话
奚|国华
胯|下呻吟
糞|便
非|典|法征用|法拆毁|常6+1|常6＋1
妈|白勺|b|蛋|比|祖|了个|的|批|逼|个|了个逼|了个巴子|卖妈屁
坦|克压大学生
喷|你|尿|水|雾蒙汗药|雾迷葯|精|血|潮|雾型迷药
福|娃|音会|娃出事|娃火车相撞地震
稀|藏
奸|夫淫妇|你|污|尸|淫|幼|情|淫电车
证|券学堂|实大法|件印章制作|件办理
駱|海堅
國|家機密|賊|產偷拍|內動態清樣|家領導人|家主席|權|產騷貨|務院|家安全|軍|產av|產無碼|民黨|產嫖娼
烧|饼歌
百|家乐|家乐赌博|性阁
谁|是新中国
·|汽车遥控拦截器
霸|工|课|餐|占土地
骑|离
臀|洞|沟|孔|丘
央|視內部晚會|视内部晚会
慧|网
森|林之鹰出售|林之狼弓弩专卖
聶|榮臻
勃|不起斯懦夫|大精深|起
刘|淇|刚|青|宾雁|通|士贤|宾深|伯承|国凯|志军|文胜|永川|延东|亚洲|俊国|晓波|少奇|晓竹|千石|山青|林智|少奇专案内幕|永清|军|文雄|云山|凯中|华清|奇葆|晓武
狂|插性器具|操|乳激揺|插|放|操你全家|插男根胶囊|干|穴
郭|金龙|俊铭|正亮|平|罗基|羅基|岩華|泉|岩华|伯雄|俊銘
r|enmingbao|fa|eddidi.com.cn|enminbao.com|enmindahuitang|enminbao|rr.xaoh.cn|enquan|fa.org|ivals|enaya|ape
薑|春雲
上|海孤儿院|门调教|门男同按摩|你|门特殊服务|海工字气枪出售|床|訪|海幫|海工字牌气枪专卖|海工字气枪指定销售点|海孤兒院|访|海帮|门保健服务|海牌工字气枪专卖网|中央|门做爱服务|海气枪网|床求欢|海气枪批发网|床不说爱|访军转干部单春|妳|门包夜服务|海工字牌气枪出售|层次|海工字牌气狗专卖|海气枪销售网
亞|洲情色網|洲bt|洲圖區|洲性虐|洲有碼|歷山大|洲淫娃|洲無碼原創區|情|洲色
耐|科尔(城镇移动)|科爾(城鎮移動)|特野战刀专卖
结|印|帐日
顯|示指定號碼|示任意號碼|示個性號碼
总|书记|统府|参谋部|政治部|局|理
碎|片製造商人馬克|片製造商人蘇克
夕|树舞子|樹舞子
辛|灝年|灏年
几|吧
平|小邓|方米|近习|反六四|码三中三|井|反|码
菩|提教会|提法门|提功
迟|浩田
希|葬|藏|望之声|拉克|特勒
罂|粟
纽|约时报
尿|忽鬼
哇|哇影院|嘎成人|嘎成人三级|噻
蒋|经国|世华|彦永|捷连|方良|公纪念歌|介石|中正
紧|穴|缚凌辱
信|仰|访|产局|用卡|息产业部|用卡读写器|用危機
点|数低|数优惠|了一首歌|对点裸聊|歌|数优
溜|冰妹联系qq
骰|宝
潘|國平|国平
鐵|道部
氧|化汞专卖
彭|丽媛；|德怀|丽媛|湖|真|德懷|麗媛
学|潮|生妹|生妹按摩包夜|生妹妹上门|运|联|大法|生妹妹兼职|位证办理|习班|百度潮|chao|生包夜|自联|历证办理|历办理|历文凭办理
氣|動鋼珠槍購買|狗销售|狗出售
浪|叫|穴|女|妇|逼|婦
迫|害大法弟子|害法轮大法|奸|害|害法轮|害法轮功
鸠|屎
根|达亚文明|敦?确吉尼玛|敦？确吉尼玛|正苗紅|正苗红
舊|斗篷哨兵
贱|b|比|货|bi|种|人|逼
恐|怖组织|怖分子皮箱炸弹|怖分子diy原子弹|怖主义|怖份子|怖分子|怖手段|怖主義|怖|怖分子必备|怖分子傻瓜手册|怖分子第一步炸弹
哥|疼|痛
釋|欲|迦牟尼
随|机面具货到付款
表|砸
廢|墟守護者|物
令|计划|狐计划|計畫
冯|东海|素英|锦华
把|钱汇到
肽|类激素
職|業復仇|業打手|業報仇
屠|光绍|杀|殺
降|低命中的圖騰
丛|林户外军刀专卖
等|你插
历|史的伤口
出|售枪支qq|售合成k粉|售水果冰|售二代個人身份证|售大馬士革鋼刀|售特警匕首|售个人商务数据资料qq|售进口模型枪|售盐酸羟亚胺qq|售海雲武士刀|售自制式64式|售各行信用卡qq|售网络高清3d成人电视棒|售楼盘业主名单|售赵氏钢珠弩|售进口硅胶面皮|售1代高仿身份證|售三箭牌汽枪|售暴力破坏王|售假冒1代身份证|售精品军刀|售海洛因|售缅古联系方式|售假2代身份证|售三棱毒刺|售杜冷丁qq|售個人1代身份證|售007间谍破解版|售軍用潛水刀|售汽车遥控干扰器|售bb枪|售白冰糖|售潜伏者免费版|售硫酸铊|售腎源|售64手qiang子弹|售54手qiang子彈|售猎枪子弹|台打炮|售枪qq|售国产手拉长狗|售54手槍|售三箭气枪|售007間諜最新版|售楼盘业主资料|售国产电动长狗|售肝源|售真实身份证|售銀行卡複制器|售警棍qq|售手枪价格|售各国军用手枪|售假人民币电话|售醋酸酐|售fx气皇|售海云武士刀|售92手qiang子彈|售高仿人皮面具|售车主资源|售汽车电子解码器|售仿真手枪|售野營軍刀|售駿馬快刀|售手机改号|售胡椒基丙酮|售小口径运动步槍|售力斯曼弩|售壹代個人身份证|售手机改号机|售鹽酸羥亞胺教程|售朝鲜冰qq|售冰牙签qq|售钻石冰电话|售警用高压棍|售各种银行卡|售制式军刀|售健卫小口径运动步槍|售军刀qq|售定时炸弹定时器|售真1代身份证|售戰術折刀|售水胶炸药|售纯冰|售假硬币|售007間諜改良版|售各种烟花爆竹|售各国制式步枪|售獵槍手槍qq|售摇头丸|售警用刀具|售高考名单|售三唑伦|售警用防身电击棒|售真正的人皮面具|售汽车芯片解码器|售中考考生信息|售猎枪qq|售军用弩|售全金属狩猎弩|售人造脸皮|售战术突击刀|售一元硬币|售储蓄卡|售短狗qq|售白冰糖qq|售胡椒基甲酮教程|售住宿发票|售藏刀专卖|售工字牌汽槍|售一代精仿身份证|售缅甸麻古qq|售腎臟|售高仿真面具|售手榴弹|售麻古教程|售白牙签教程|售54手枪子弹|售业主名单qq|售乳胶面皮|售肝臟|售手机x卧底破解版|售鹰飞凌军刀|售贝尔求生刀|售麥角酸教程|售high粉教程|售客户信息|售人民币|售buck夜鷹平刃|售台湾版假币|售公司法人资料qq|售彩信改号|售flexispy增强版|售間苯三酚教程|售健卫小口径|售真身份證|售骏马快刀|售軍用匕首|售狙击枪qq|售氰化物qq|售2代高仿身份證|售高清网络电视棒|售护士证|售军用狙击弩|售甲基苯丙|售高档客户资料|售十字锁万能钥匙|售冰毒教程|售手拷|售蝴蝶跳刀|售电话营销数据|售麻果qq|售股民名单|售92手qiang子弹|售小飞虎|售白牙签qq|售朝鲜仿真版假币|售金融客户资源|售彈簧刀|售54式64式|售夏装短袖警服|售仿真军刺|售金属枪模|售进口硅胶脸皮|售真实壹代身份证|售信用卡復制器|售二代高仿身份證|售個人2代身份證|售壹代高仿身份证|售高仿真假币|售各种银行信用卡|售冰毒供应|售过机假钱|售日本武士刀|售健卫14步枪|售任意显号软件|售银行卡读卡器|售各国军用步枪|售tnt|售个人1代身份证|售壹代個人身份證|售97步枪子弹|售c02款式枪|售植物冰qq|售真枪|售高压狗|售個人1代身份证|售假1代身份证|售假钞|售雷管炸药自制炸弹|售山猪气枪|售77猎槍|售健衛小口徑|售56军刺|售猎槍|售麻果配方|售缅果|售假冒1代身份證|售潜伏者专业版|售手机x卧底最新版|售戰術突擊刀|售手槍子彈|售黃麻素|售自制式64式枪|售军用弓弩|售个人信息|售潜伏者增强版|售开山砍刀|售网络usb电视棒|售五连发猎槍|售步qiang|售假钱电话|售军官证|售64式手槍|售军品77式手枪|售高仿真枪支|售溫切斯特|售手枪子弹|售一元硬币假钞|售成人电视棒|售车主名录|售苯乙酸|售冰毒qq|售手枪电话|售秃鹰气枪|售2011年全国高考生名单|售ffx氣槍|售手機間諜|售盐酸曲马多|售法人手机号码|售广告费发票|售黄冰|售刀具|售野营军刀|售美女|售枪支|售各种气枪|售64手槍|售銀行卡復制器|售战神弓弩|售气枪qq|售手机变号软件|售摇头糖教程|售麦角酸教程|售提供军用l枪|售广州三箭|售勃朗宁军刀|售冰牙签|售短信改号|售54手qiang子弹|售三唑仑片qq|售小果子qq|售x卧底|售麻古k粉|售蝴蝶甩刀|售小口径步槍|售法人通讯录|售化学冰牙签|售麻谷教程|售警服装备|售硅胶人皮|售军品刀具qq|售个人壹代身份證|售三唑侖|售高纯度冰糖|售汽车信号解码器|售法人通讯录qq|售股民资料|售个人信息资料|售弩|售猎qiang子弹|售迷魂药教程|售左旋麻黄素教程|售64式手枪|售64手槍子彈|售小飞狼|售汽车遥控复制器|售大冰磚教程|售单管猎枪|售美国秃鹰|售各类考生信息qq|售1代精仿身份證|售真二代身份證|售2代高仿身份证|售1代精仿身份证|售一元人民币|售动物麻醉枪|售车主资料|售各种进口气枪|售64手qiang|售54手槍子彈|售羟基環戊基|售股民资源|售易容人皮|售双管猎枪|售真实1代身份證|售野戰刀|售高清3d成人电视棒|售92手槍子彈|售大麻|售日本成人dvd|售左旋麻黃素教程|售走私步枪|售手qiang子弹|售假钞电话|售健卫20步枪|售股民电话资源|售钻石qq|售文凭|售77式手枪|售假钱货到付款|售007间谍最新版|售白牙簽教程|售军用制式92式|售氰化钠qq|售1代個人身份證|售仿古|售迷魂水教程|售56式冲锋枪|售走私小口径步枪|售信用卡|售妹妹|售美军骑兵刀|售甲基苯丙胺|售沙漠之鹰|售黄牙签教程|售开心水|售假壹代身份证|售神仙水教程|售黃體酮|售二代身份证|售信用卡用户资料|售仿真人皮|售枪弹|售专业手铐qq|售氰化钾药物|售仿真来复枪|售一代個人身份证|售步枪子弹|售麻醉l枪|售销售气槍|售纯冰qq|售氯胺酮qq|售k粉教程|售汽狗|售气狗qq|售二代假身份證|售野营手斧|售高仿真人民币|售考生名单|售64手qiang子彈|售手铐|售水晶冰|售武士刀|售真一代身份证|售上海工字气枪|售狩猎弩|售手機改號機|售假币货到付款|售网银卡|售开锁器|售走私冲锋枪|售炸药电话-警察-广告|售锡纸开锁视频教程|售散弹槍|售伪币|售兰博求生刀|售可卡因|售钻石冰糖牙签|售黄麻素|售身份证原料胶粒|售麻果|售單發麻醉槍|售毒品|售伪钞|售精仿三棱军刺|售短信改号软件|售高仿脸皮|售2代個人身份證|售钢珠猎狗|售西班牙奥托军刀|售突击步枪|售改号器|售打猎枪|售各种防身电警棒|售各类考生名单|售4号白粉电话|售個人一代身份证|售军用枪|售期货客户资料|售高壓氣槍|售64猎枪買賣|售三唑侖教程|售真2代身份證|售走私猎枪|售万能开锁器|售原装猎枪|售老板个人资料|售警官证|售一张2代身份证|售仿真面具|售92手槍|售k粉|气报仇|售警用商品|售高清网络tv棒|售热缚纸假币|售高考考生报名信息|售纯冰钻石白冰|售纯冰钻石黄冰|售军警用品|售职称证|售假冒身份证|售007間諜破解版|售手机007|售汽车屏蔽器|售仿真汽枪|售银行卡复制|售原装猎l枪|售高仿纸币|售手枪|售乳胶面具|售二代精仿身份證|售一代個人身份證|售手qiang子彈|售双管平式枪|售警服|售人造面皮|售散弹狗|售追月|售左旋黃麻素|售过机版假钱|售92式手槍|售溫切斯特1000x|售k粉qq|售定制人皮面具|售警服春秋执勤装|售爆竹|售甲卡西酮合成教程|售真实2代身份證|售盐酸羟亚胺电话|售德国a1000|售手qiang|售步qiang子弹|售54式手枪qq|售车主资料qq|售真实壹代身份證|售真实2代身份证|千|售硝酸甘油|售车主名单|售警用匕首|售任意号码改号|售乙醚|售进口枪支|售他人姓名银行卡|售仿真脸皮|售usb电视棒|售纯冰钻石|售氰化钾电话|售壹代假身份證|售007间谍增强版|售易容面具|售酒店发票|售迫击炮弹|售蘭博求生刀|售专业手铐|售彩信改號軟件|售警察证|售库尔喀弯刀|售式手枪qq|售纸币货到付款|售海洛因qq|售手狗qq|售銀行卡讀卡器|售各类军用枪|售力思曼弓弩|售楼盘业主资料qq|售香港最新版假人民币|售二手弓弩|售1代假身份證|售手机间谍|售冰磚教程|售各校考生信息|售麻醉qiang|售高仿假钱|售77猎枪|售flexispy专业版|售各类考生名单qq|售毕业证|售手压短狗|售自制炸弹|售春秋执勤装警服|售汽车拦截器|售制式軍刀|售防身电击棒警用|售45mm狗粮|售定时炸弹|售身份证原料薄膜|售92手枪|售冰古|售风城枪|售朝鲜版假币|售汽车解码器|售63式军刺|售警用头盔qq|售股民电话|售c1e假币|售雷管qq|售缅古|售80年老版假币|售健卫步枪|售马古|售身份證生成器|售弹药联系|售仿真人皮面具|售4.5mm铅弹|售手機變號器|售壹代精仿身份证|售flexispy免费试用|售95步枪子弹|售居民身份证|售冷鋼三美武士刀|售手qiang价格|售假币联系电话|售m300|售心脏|售个人一代身份证|售汽车干扰器|售氰化钾|售圣甲虫跳刀|售炸药联系|售假冒一代身份證|售手機改號器|售汽车电脑解码器|售进口硅胶人皮|售俄罗斯654k|售手机x卧底免费版|售麻黄素|售考生名单qq|售液体炸弹|售64手枪|售壹代假冒身份证|售白冰|售各行借记卡qq|售三棱军刺|售个性号码改号|售军用潜水刀|售个人信息qq|售氯胺酮教程|售king粉|售氰化汞|售胡椒基甲酮合成教程|售高仿真脸皮|售二代假冒身份證|售仿真槍模|售硅胶面具|售气qiang|售小口径手枪|售白粉教程|售钞票|售业主资料|售力思曼弩|售巴雷特|售罂粟碱|售av|售真一代身份證|售手机改号器|售2代假冒身份證|售溜冰工具|售曲马多|售假钱qq|售阻击枪|售假币qq|售神仙糖教程|售锡锋枪|售爆竹qq|售股民信息|售king粉合成教程|售唐刀|售64手枪子弹|售麻醉钢枪qq|售一元硬币司|售小口径运动步枪|售2代精仿身份證|售壹代高仿身份證|售个人2代身份证|售二代高仿身份证|售2代精仿身份证|售尼泊爾軍刀|售美國m7軍刺|售麦角醇|售假币当面交易|售银行卡用户信息|售股民联系方式|售丙酮|售個人壹代身份證|售2代假冒身份证|售手机变号器|售陶瓷刀具|售一代假冒身份證|售lqb362|售解放军现役军刀|售单管獵槍|售麻古果子|售二乙酰吗啡qq|售自制气枪qq|售残疾证|售军用手枪|售乳化炸药|售|钢珠枪|售二代真实身份证|售警用头盔|售一代高仿身份證|售搖頭糖教程|售假币联系方式|售肾脏|售一元硬币qq|售m1枪刺|售小口径步槍子弹|售手枪qq|售猎豹弩|售个人2代身份證|售flexispy免费版|售冰鉆石教程|售k粉麻黄素|售左轮枪6连发|售借记卡|售007间谍改良版|售獵槍麻醉槍|售冰砖|售壹代假冒身份證|售万能钥匙|售假钱|售土炸弹|售81军刺|售三棱軍刺|售半自动猎枪|售军刀军品|售乳胶脸皮|售真实身份證|售假冒壹代身份證|售麻黃素教程|售钻石冰教程|售三唑仑片|售开锁工具qq|售枪弹qq|售真实二代身份證|售ak-47刺刀|售ak军刺|售野战求生刀具|售c4|售军用手qiang|售氯胺酮电话|售个人商务数据资料|售乙醚qq|售氰化钾qq|售左旋麻黄素|售高清晰假钞|售高档客户资料qq|售指定号码改号|售美軍騎兵刀|售银行客户资料|售成品冰毒|售企业名录资料|售骨髓源|售秃鹰汽枪|售钻石冰|售各种k粉|售肾源专卖|售手機碟中諜軟件|售胡椒醛|售猎枪电话|售各类警用装备|售肺脏|售海豹m9|售警用手铐|售全球网络电视棒|售各国制式手枪|售银行客户资料qq|售电话营销数据qq|售钢珠弩|售工字气qiang|售白牙签|售弓弩|售手枪手机|售警服警用品|售进口pcp|售007間諜專業版|售flexispy最新版|售盐酸羟亚胺教程|售虎头牌猎枪|售易容面皮|售仿真面皮|售肾源|售tops鋼鷹戰鬥刀|售单发麻醉枪|售假rmb|售户外砍刀|现暴动|售高仿真面皮|售假一代身份證|售各種銀行存折|售走私军火|售真实一代身份证|售cfx气枪|售耐特野战刀|售格鬥靴刀|售走私砂枪|售警用手铐装备|售新版假人民币|售假1代身份證|售禿鷹汽槍|售pcp新贵|售军品刺刀|售小区业主资料|售高仿真人皮|售手机x卧底改良版|售战术折刀|售朝鲜版硬币|售信用卡用户信息|售老板通讯录|售新股民信息|售伪钞qq|售硅胶面皮|售美國卡巴軍刀|售乳胶人皮|售胰腺|售手机变号机|售大黑鹰弓弩qq|售处男|售摇头丸qq|售假人民幣|售左轮钢珠狗|售虎頭獵槍|售真实二代身份证|售军用匕首|售56軍刺|售军品77式手qiang|售k粉电话|售警用高压电棍|售火药|售黄牙签qq|售改号软件|售54手枪qq|售假人民币qq|售手機變號軟件|售假冒2代身份证|售假发票qq|售高仿假人民币|售银行卡用户资料|售防身警用装备|售个人二代身份证|售毛瑟刺刀|售军用手槍|售步槍子彈|售麻古|售假人民币|售小口径步枪子弹|售麦角酸合成教程|售高仿人皮qq|售手机007间谍软件|售遥控解码器|售高仿真假钞|售朝鲜版高仿真假钞|售老板通讯录qq|售盐酸曲马多片|售新款电警棍|售双管猎枪出售|售黑火药|售2代個人身份证|售雷管炸药|售神符|售白冰黄冰qq|售金属手拉鸡|售猎枪霰弹|售硅胶脸皮|售麥角醇|售铵梯炸药|售虎头猎枪|售警服及警用品|售猛虎军刀|售网络电视棒qq|售掌心雷|售假冒二代身份證|售假冒身份證|售台湾秃鹰|售各行储蓄卡qq|售黄冰白冰|售神仙糖制作教程|售手机窃听软件|兵|售自製手狗|售森林之豹|售汽车遥控拦截器|售枪支联系|售假钞票qq|售台湾最新版假人民币|售土炸药|售走私手枪|售社区业主名单|售假二代身份證|售假身份證|售短信改號軟件|售精仿军刃|售黄冰白冰牙签|售各类考生信息|售一元模具|售改手机号软件qq|售手工猎刀|售高压汽枪|售磚石冰毒|售个人壹代身份证|售个性号码变号|售解放軍現役軍刀|售黄白牙签|售过机假钞|售匕首|售高清成人电视棒|售港38式左轮枪|售54式麻狗|售戈博军刀|售专业警枪|售信用卡讀卡器|售苯基丙酮|售冰du|售肝脏|售小冰磚教程|售摇头丸教程|售假币|售54手狗子弹|售各种制毒工具|售手機變號機|售手机监听软件|售纯冰黄冰|售肝臟qq|售银行卡复制器|售flexispy改良版|售仿真气枪|售真实一代身份證|售個人二代身份证|售进口枪|售甲基安非他明qq|售虎牙军刀|售一代假身份證|售指定号码变号|售麻黄素原料|售一代精仿身份證|售真壹代身份证|售硬币|售麻醉槍|售尼泊尔军刀|售高仿面具|售海洛因教程|售眼角膜|售jia币|售m92f式手槍|售三唑仑|售汽车解码器软件|售猎刀|售假文凭|售真壹代身份證|售手机x卧底专业版|售警衔警服|售氯苯基|售折叠款式枪|售健卫15步枪|售公司电话资源|售水果冰qq|售国产高压电警棍|售54手枪|售易容脸皮|售甲状旁腺源|售企业名录资料qq|售缅果电话|售假币tel|售2代假身份證|售任意顯號軟件|售铊盐|售假证|售各型号烟花爆竹|售氰化钠|售间苯三酚|售冒名信用卡|售高仿真人皮面具qq|售骚本气枪|售king粉教程|售小口径步枪|售雷管炸药qq|售身份信息|售单发气枪|售战刀|售甲卡西酮教程|售办公用品发票|售个人1代身份證|售真2代身份证|售手机x卧底免费试用|售手铐qq|售黄体酮教程|售迷魂粉教程|售麻黄素k粉|售54枪qq|售手机x卧底增强版|售92手枪子弹|售高假仿人民币|售单管猎槍|售迷魂藥教程|售上海工字牌气枪|售麦角酸|售处女|售左旋麻黄素合成教程|售92手qiang|售耐特野戰刀|售斗角式枪|售五连发猎枪|售假冒二代身份证|售flexispy破解版|售黃牙簽教程|售假壹代身份證|售海軍突擊刀|售军刺|售猎qiang|售信用卡qq|售潜伏者手机监听软件|售五连发猎l枪|售动物麻醉槍|售手机碟中谍软件|售氫化可的松|售瓦斯手狗|售炸药qq|售烟花|售个人二代身份證|售连发猎槍|售折刀|售步qiang子彈|售人皮面具|售国外最新版假人民币|售股民电话资源qq|售腎脏|售1代個人身份证|售任意号码变号|售極端武力捕鯨叉|售猎l枪|售公司法人资料|售小冰砖教程|售间苯三酚教程|售麻黄素教程|售单管猎l枪|售炸药电话|售硝酸铊|售56式军刺|售冰zhuan|售警灯|售壹代精仿身份證|售美国冷钢军刀|售港38式左轮|售一元假硬币|售过机假币|售开刃军刀|售步枪qq|售11年高考考生信息|售個人一代身份證|售森林之虎|售车主名单qq|售业主名单|售溜冰壶qq|售真实1代身份证|售工字牌氣槍|售假币电话|售伸缩型电警棍|售小区业主名单|售户外狩猎弩|售简易炸弹|售砒霜|售假2代身份證|售迷魂烟|售警械|售假币假钱|售散弹枪|售三棱刺|售搖頭丸教程|售大冰砖qq|售高考考生信息|售假发票|售下压款式枪|售进口气枪|售3d网络电视棒|售警用电击器|售信用卡资料|售1代高仿身份证|售007间谍专业版|售银行卡|售此号|售007间谍免费试用|售克隆银行卡|售56式半刺刀|售车主信息|售车主资源qq|售彩信改号软件|售高纯度砒霜|售邻氯苯晴|售假冒2代身份證|售手機改號軟件|售潜伏者免费试用|售大马士革钢刀|售黄牙签|售刺刀|售车主名录qq|售警徽|售18p2p账号|售美國sog軍刀|售钻石冰毒|售高纯k粉|售一元硬币货到付款|售秦氏弩|售qi狗|售假冒壹代身份证|售flexispy增強版|售多功能折刀|售庫爾喀彎刀|售38枪|售高仿面皮|售奶油冰教程|售獵qiang子彈|售叛逆者枪|售公司内部客户资料|售高仿人皮|售二代精仿身份证|售军用制式92式枪|售匕首qq|售客户资料|售個人壹代身份证|售一元硬币电话|售咖啡因|售個人二代身份證|售步槍|售個人2代身份证|售真二代身份证|售化学冰qq|售新版假硬币|售缅甸麻古|售一代高仿身份证|售锡纸开锁工具|售007间谍免费版|售台湾版高仿真假钞|售水晶冰qq|售假钞qq|售钻石冰糖缅古牙签|售潜伏者改良版|售美国巴克军刀|售蝴蝶刀|售个人身份信息|售假人民币货到付款|售眼角膜源|售真1代身份證|售獵狗|售子弹|售大冰砖教程|售hd90版假币|售甲卡西酮|售工字牌汽枪|售ghb水|售汽车锁解码器|售个人一代身份證|售開山砍刀|售走私狙击枪|售朝鲜版人民币|售氰化物|售弹簧刀匕首|售丙酮qq|售pcz山猪|售1代假冒身份證|售鉛彈氣槍|售答案|售二代個人身份證|售潜伏者破解版|售迷幻药|售账号|售麻谷qq|售假冒一代身份证|售真实身份证银行卡|售手槍价格|售冰毒|售警服常服|售钻石冰糖qq|售各类电警棒|售缅古qq|售气槍|售假bi|售獵槍|售冰砖教程|售乙醚教程|售小口径手枪qq|售獵槍子彈|售氯胺酮|售一元假币|售改號軟件|售盐酸羟亚胺|售老板个人资料qq|售自制连弩qq|售进口硅胶面具|售五连发猎qiang
贞|操|操带手铐
串|联聚会
坚|修大法
男|女秘事|女自慰用品|女交歡|根增长sex吧|女交欢|女蒲典|妓|女公关|女激情淫乱|奴|人性息|同成人視訊
蠼|毵
葉|菊蘭|劍英
单|管猎枪结构图|管猎枪专卖|选|管猎槍专卖店|管猎枪買賣銷售|管猎槍出售|管猎枪出售|管猎枪买卖|管猎枪专卖店|春天网|管獵槍出售|管猎槍销售
聯|總
冷|钢刀具直销网|钢刀具军品网|钢出售qq|钢专卖qq|鋼三美武士刀专卖
脫|內褲
姚|月谦|罗|文元|羅|月謙
保|持正念|钓组织|罗二世教皇|密局|监会|釣|钓联合会军委公开信|先|真发票|健女上门|钓|鲜|密室
那|娘老比|娘瘟比|嗎b|吗错比|吗逼|吗老比|娘错比|嗎逼|嗎瘟比|娘錯比|吗瘟比|嗎錯比|嗎老比|吗b
桑|德茲
李|磕墙|慶華|鵬|永萍|大钊|录|春城|老师|長春|愚蠢|红痔|滨|鹏病重|克強|弘旨|庆华|登辉|宏志|宏治|荣融|宏旨|洪志先生|鹏|岚清|兴平|义强|文斌|旺阳|磕牆|鐵映|世辉|学举|建国|志绥|遠哲|興平|蘭菊|錄|志綏|少民|远哲|山|国谅|嵐清|月月鸟|洪寬|月月鳥|淑娴|源潮|克强接班|祿|兰菊|毅斌|沛瑶|peng|敖|鹏*|瑞环|紅痔|慶安|铁映|大師|大釗|克强|旺陽|總理|元龙|继耐|文忠|长春|淑嫻|小鵬|总理|登輝|总统|洪宽|洪志|大师|繼耐|锐|先念|小琳|现原|瑞環|洪志师父|俊毅|建平|红志|老師|總統|禄|天羽|小朋|小鹏|洪志大师|庆安
金|属仿真手枪专卖网|钟气枪出售|钟气枪qq|钟气枪出货|日成|堯如|学圭|钟气枪制造|钟气枪电话|钟气枪到货|盾工程|麟岂是池中物|卡会员资料|戈铁马|融客户资源qq|卡|顶|歪日|普提上师|币抽|泽辰|钟气枪图纸|尧如|瓶梅|泽文子|瓶梅在线观看|正恩|枪不倒|属铊出售|钟气枪订购|鳞岂是池中物全本|正日|澤文子|学奎|鱗豈是池中物|木棉蓝盾在线娱乐|鳞岂是池中物|毛穴|币许愿|堂黄牙签|领白领数据|槍不倒|澤辰|麒麟网
异|見人士|型叛軍|議人士|己|见人士|议人士
羟|丁酸
病|毒|毒营销
授|权弓驽专卖店
奴|隷调教|畜抄|隸魔族士兵|隷調教
寶|石商人
o|oo.xaoh.cn|kaygood.cn|sisa.cn|ppression
紅|燈區|色恐怖|炎猛獸|志|智
荊|棘護衛兵
氯|胺酮|化汞供应|胺酮配方|胺酮销售|胺酮qq|胺酮出货|胺酮电话|胺酮货到付款|胺酮供應|胺酮出售|胺酮付款qq|胺酮订购|胺酮到货|胺酮送货上门|化氢
柔|阴术|陰術
禁|区|片|看|毒和反邪教|书
嬉|游花丛
丝|诱|袜淫妇|袜美女上门服务|袜足交|袜美腿|袜按摩服务|袜|袜写真|袜妹妹兼职|足诱惑|袜高跟|袜小姐按摩|袜妹妹服务|袜聊天室
扌|由插
客|户服务|服|戶服務
修|大法|正发|炼法轮功|改手机号码软件|煉|炼|练
变|频棒
食|精|捻屎|屎
钻|插|石许愿|石抽|石冰糖qq|石冰订购
腐|败症腐|敗|败|败中国|败大业
告|全国同胞|全国同胞书
雇|佣打手qq|用打手|佣杀手|人报仇|人報仇|杀手qq|人打架|人复仇|人復仇
和|采开奖|彩开奖|锅枪|平请愿书|平改革八位一体|鍋槍
9|2手枪价格|2手qiang子弹提供|2手枪子弹提供|2ey.com|6766702|2气狗qq|2枪专卖|2手qiang子彈供應qq|2手枪出售|7sese|风|2手qiang价格|2手槍買賣銷售|2手qiang子彈銷售|2手枪子弹出售|.635|2式出售|2手槍子彈提供qq|2手qiang子彈訂購qq|7步枪子弹供应|2手槍子彈提供|2手qiang子弹供应|2手qiang子弹出售|91game.com|2狗qq|2式9mm手枪销售|5步枪子彈供應|2手qiang子彈提供|2手槍出售|2手qiang子彈訂購|2手qiang子彈出售|评|3.1政策|2手狗qq|5步枪子彈供应|2手qiang子彈電話|1bysd.cn|2wydl.com|6800266|2手qiang出售|3手狗买卖|ping|2手qiang子彈提供qq|2手枪子弹电话qq|2手qiang子弹订购|2手槍价格|11|2手槍子彈供應|2手槍子彈銷售|2klgh.cn|2枪支出售|2手qiang子弹提供qq|2手qiang子弹销售|2手枪子弹销售|学|2式枪专卖|2式手槍出售|2手槍子彈供應qq|2手枪子弹供应|9sa.com|2手qiang子弹电话|2手枪销售|9bb|6766722|2手枪子彈供应|7步枪子彈供應|2手槍子彈出售|2手槍54式手槍|9%的冰|2手槍子弹訂購|2手槍专卖|7步枪子彈供应|7激情网|2手qiang子弹供应qq|2手枪子弹供应qq|2手枪子彈供應|2式军用手枪出售|99日本妹|2手槍子彈訂購qq|2猎枪買賣銷售|2手狗出售|5步枪子弹供应|2手狗买卖|2手qiang子彈供應|2手槍销售
關|卓中
籌|碼
镇|压|压图片|压法轮|压法轮功
貓|肉
寒|潭鹤影
贷|款理财
负|面信息删帖qq|面信息删除qq|面信息删除|面新闻信息删除|面新闻删除
富|兰克林|锦失地要人权
輪|盤賭|奸內射|大|公|操|暴|功|奸|攻
佳|丽
卡|蓮|洛齐|巴军刀出售|羅迪|斯特罗|务部|号抽奖|扎菲|斯楚|莲|罗迪|洛齊
g|巴|叭|m|ongchandang|ruepin|igabyte.cn|点刺激棒|ong和|水|掰|cd|uojia|angcunxiushu|angcunningci|ogo.net|365.net|ardennetworks.com|ay片|芭|点|aolipiao|匪|fw|點|八|ame|ssmtt.com|eocities.com|产|c党|ong党|片|amemaster|uobaxiong|an你|点高潮
性|色|交无码|福|爱动画|器|交图片|息中国|爱淫图|息|爱|爱小说|感内衣裤|愛擂臺|感誘惑|友谊|无能|开放的|感|僻|戰擂臺|服务工作者|骚扰|之站|爱擂台|愛世代|吧有你春暖花开|感肉丝|情中人|愛自拍|交片|交易|游戏|爱视频|虎|交自拍|战擂台|無能|技巧|行为|傭|爱五月天|启蒙老师|爱用品|交圖|教官|爱聊天室|爱图库|奴|交吞精|福綜合論壇|酒吧|愛|感肉絲|乐园|爱自拍|吧春暖花开|感诱惑|爱漫画|中性|愛插穴|交电影|吧最新地址|电影|开放俱乐部|愛圖庫|感乳娘|服务|吧|欲|虎色网|饑渴|爱聊天|爱动画片|爱ａ片下载|感骚b|佣|交|高潮|免费电影|虎色網|孽待|伙伴个案考察|爱视频下载|经验|交课|饥渴|事|学教授|交課|虐|虐待|爱动漫|感妖娆|愛圖片|爱文学|伴侣|交图|感猫装|交無碼|感妖嬈|奴会|奴會|生活|爱ａ片|色社区
慶|紅
氵|去車侖工力|去車侖工力?|去|去车仑|去车仑工力|去车仑工力?
美|女走光|女成人|女祼聊|女qq裸聊|国卡巴军刀专卖|国军用进口弓弩|国佬|女裸聊qq|女色情|女激情视频网|女高潮|國參考|国参考|利坚|女貼吧|女裸聊网|艳少妇视频诱惑|女吞精|臀|沙酮|女激情视频|女裸体|屄|女|国|女裸体视频聊天|女上门兼职|国秃鹰到货|女面对面激情裸聊|女淫穴|腿|女裸图|女兽交|國sog軍刀专卖|女会所|少女|逼|少婦|臀夹阴|女qq裸舞|女色图|尻中出|国秃鹰出售|腿丝足|乳斗艳|國佬|腿絲足|化人皮货到付款|女视频聊天室|女性爱美图|少妇|體豔姿|女出台服务|乳人妻|國冷鋼軍刀专卖|国sog军刀专卖|国三箭气枪出货|骚妇|乳鬥豔|国冷钢军刀专卖|女兼职|国秃鹰电话|国之音|穴|乳|臀嫰穴|女裸舞|女裸聊视频室|女性交|少妇的哀羞|騷婦|女裸聊网站|女裸聊视频|国秃鹰订购|女裸体视频聊天室|國|女中出|女包夜服务qq|女视频裸聊|女全套|少女包夜|国色情基地|女看穴裸聊|国秃鹰qq|女性交真图|女出售|國之音|女视频|少女中潮|女上门援交|國巴克軍刀专卖|国秃鹰制造图|国军刀专卖|女脱衣|女上门|幼|体艳姿|乳美穴|联社|女视频聊天|女激情裸聊|國卡巴軍刀专卖
專|業打手|業打手公司|政|制|业打手公司|業報仇|業復仇
压|迫
帮|人讨债|人制造意外死亡|人报复|彩信改号|人绑架|人了仇|短信改号|个性号码变号|人被欺负|人敲诈|人报仇qq|手机改号|人追债|人了难|任意号码改号|人杀人|人勒索|人清债|人报仇毁容|指定号码变号|任意号码变号|人砍人|人打架|人报仇|人消灾|人毁容|人处理恩怨|人出气
奈|美
惡|靈咒術師|狼看守
纯|一郎
臺|灣獨|湾國|盟|灣建國運動組織|灣民國|灣政論區|灣帝國|灣青年獨立聯盟|灣島國|灣狗|灣共産黨|灣自由聯盟|灣國|灣獨立
萬|里|潤南|維讀者論壇|曉東|淫堂
書|記
鄉|巴佬
斧|头镰刀
帶|套肛交
黃|金聖水|牙簽配方|牙簽送货上门|色小電影|禍|劍輝|片|仲生|慈萍|麗滿|色電影|牙簽出货|牙簽到货|牙簽销售|金幼龍|菊|大仙|色網站|體酮销售|伯源|翔|義交|牙簽订购
稅|力|務總局
家|族势力|庭乱伦|乐福
租|赁高仿面具qq|赁乳胶面具qq|赁乳胶人皮qq|赁明星面具qq|赁易容面皮qq|赁进口硅胶面皮qq|赁进口硅胶脸皮qq|赁硅胶人皮qq|赁乳胶脸皮qq|赁美化面皮qq|赁进口硅胶面具qq|赁弹簧面具qq|赁随机面具qq|赁硅胶面具qq|赁进口硅胶人皮qq|赁乳胶面皮qq|赁高仿真面皮qq
阝|月
丸|仔
啪|啪啪|死你
郁|慕明
仓|井空
忍|好
鹽|酸羥亞胺出货|酸羥亞胺订购|酸羥亞胺到货|酸羥亞胺销售|酸羟亞胺合成|酸羥亞胺送货上门|酸羥亞胺配方
禽|獸|兽
快|樂av|播a片网|速刻章办证|速删帖|播女优|播成人电影|色吧|速办证刻章|速办理文凭|速代开发票|乐av|播av电影|播成人|速办理证件qq|播成人视频|速办理驾照|活谷论坛|速办理假身份证|速办证刻章qq|速办证qq
z|hidian8.com|huanfalun|y666.net|x002.com|hadan|houjiankang|uanshi1000.cn|ha药|hayao|hu所生！|hude|zmysf.com|ang人|xsj188.com|aixu.net|东|houenlai|henzhu|huanfalunadmin|hengjianwang|hengfu|hangdejiang|engpeiyan|hengjian|f大楼|ha弹|huanfalu|houxiaokang|f|e东|emin|edong|hanggaoli|honghuaminguo|engqinghong|hangchunqiao|henshanren|zz.xaoh.cn|e民|i杀|hurongji|houyongkang|haoziyang|angdu
别|他吗|梦成灰
怎|么购买迷情药
聂|荣臻
爷|爷
論|攻|壇管理員|公|功
懶|教|叫
赃|车
售|军用手枪|高仿真人民币|軍用手枪|电警棍|枪|卖武器|号|氰化物|冰毒|各式气枪|氰化物qq|麻醉联系电话|游戏币|假钞qq|砍刀|枪qq|id|一元硬币|软件
完|蛋操
鄭|寶清|麗文|義|餘鎮|源|運鵬
兵|运|力部署
汕|尾东洲|特农信社|头农村信用社
母|子奸情|女雙飛|子交歡|子姦情|子乱伦自拍|奸|女双飞|子交欢|子
c|hairmanmao|nd|henyun|ao你|ao你大爷|hinaliberal|4炸弹制作方法|henduxiu|arrefour|ocain|annabis|henshuibian|5c8.cn|hailing|s|restbone|fx气枪出售|lient|henliangyu|hinavfx.net|4塑胶炸药制作方法|4炸药制作方法|unts|4炸药的成分|hinesenewsnet|dream.com|hunyilang|aob|ha你|hinamz|readers|4炸药|aogangchuan|aobi|lockgemstone|naicheng.1174.net.cn|anyaa.com|henyi|hengrenwangzhi.1242.net.cn|4塑胶炸药|c小雪|onsignment5173|learwisdom.net|henzhili|ao你妈|hengrenmanhua.1242.net.cn|ikcatv.2om|hongxianmu.cn|ommunistparty|hinesedemocracy|djp|vceo.com|ao
[|1998]7号文件|[<六>－(彩)]]
亢|议
澤|夫|民
硒|藏
强|效失意药|取|奸小说|j|姦|制浣肠|歼|奸幼女|奸犯|奸处女|制拆除|拆当地居民房|奸丸|盗警察|夺|暴sm|暴电影|奸|卫|迫|暴幼女|jian|硬发言|暴|奸粉|制捐款
穷|逼
s|m用品|ewuyuetian.1274.net.cn|henycs.co|o@djy.co.jp|pyera软件|ex|jlike.com|ecretchina.com|im卡|uicide|aqieer|b|ewuyuetian.1174.net.cn|ex性吧有你|adamu|hanbenwushiliu|ervebeer.com|im卡抽奖|m后庭器具|f网站定做|pyera软件出售|m女王|unwen|amalanqi|m|imple|ucker|occer01.com|exinsex|pyera软件供应|ex聊天室|pyflexispy软件|m援交|erver|f|pyflexispy下载|m虐待|idalin|afeweb|ecom|unyixian|pyera软件下载|tlmbbs.cn|trychnine|m調教|pyera软件官方网站|m新图作品|hijiamouni|ongchuyu|hit|n8遥控解码器|m捆绑|aobi|uck|vdc|zlmgh.cn|eqing|e色成人网|howka8.com|leepingpill|elf-immolation|hangfang|m调教|ystem|unzhongshan|m舔穴|iwameitui.1274.net.cn
灭|族|共|亡中国
柯|賜海|建銘|赐海|建铭|俊雄
滅|族
姫|辱|島瑠璃香
统|独论坛|一教|战部|一股市|独光谱
然|并卵
伊|斯蘭|斯兰团|拉克伊斯兰国|斯兰解放组织|東|丽莎白|力哈木|扎布特|朗|斯兰原教旨主义|斯兰运动|拉克|德|斯德|斯兰亚格林尼斯|斯兰原教旨主义者|斯兰|莎貝爾|斯蘭亞格林尼斯|斯兰国|斯兰马格里布基地组织|斯兰军|斯兰教
爽|死我了|死|片|电影|穴
行|房|政院
鲍|岳桥|威尔|彤|戈
望|月
腳|交
诸|世纪
至|尊情色王朝|尊狼威
巴|倫侍從|倫坦|赫|哈依教
欲|女|火焚身|色成人网|望之都|生欲死|火|仙欲浪|仙欲死|望|罢不能|医天下
勞|動教養所|改|教
喇|嘛
靓|号|女主播
尽|情纵欲
菜|逼
顏|面射精|射|騎|射自拍
肥|逼
写|真
抛|出惊天言论
戳|那嗎b|那嗎逼|你|b|逼|那吗b|那吗逼|那嗎比|比|那吗比
鬥|士哈夫拉蘇|士霍克
古|柯碱|柯买卖|龍祭壇|兰经|怪歌
積|克館
红|兽|志|智|音|灯区|魂网站|色恐怖|色贵族|卫兵|蜘蛛迷奸药
示|威|wei
穴|爽|淫|口|肉|图|海|圖|洞|里|前庭|穴
胸|濤乳浪|推|罩|摧
嗎|的|啡|啡片
拍|丸|肩神药|肩迷药出售
千|门六决
鉛|彈氣槍销售|彈氣槍出售
曾|庆红|培炎|慶紅|道人六合彩|道人六合彩公司|宪梓|荫权|道人|志朗|道人特码
易|容面皮货到付款|丹轩|通高科|容面具qq|容脸皮qq|容面具货到付款|丹軒|志熹|容人皮qq|容脸皮货到付款|容人皮货到付款
尹|庆民|慶民
罄|竹难书
匹|配器官服务
墮|淫
雪|山獅子旗|野あいか电驴下载|山狮子旗|腿玉胯|山狮子
靠|爸|母|北|你媽|你妈|腰
埃|裏克蘇特勤|斯萬
伍|凡|世文
早|泄
景|涛
咖|啡因
妞|妞基地图片|妞成人基地
辦|畢業證|理本科文憑
集|體淫|體性愛|体性爱|体淫|体签名|体自杀|团长期
處|女膜|女開包|女
憂|鬱的艾拉
车|主名录|锁干扰器|门防盗干扰器|门锁遥控干扰器|门干扰器|仑工力|仑女干|门解码干扰器|仑|臣
审|查
陷|害法轮功|家
癟|三
吕|秀莲|京花|祖善
找|人办事毁容|小姐上门qq|打手qq|職業殺手|职业杀手|人消災|人辦事毀容|人勒索|职业杀手qq|肾源|人敲诈|殺手|小姐全套服务|小姐上门服务qq|人帮报仇|人毀容|一夜晴网|小姐包夜qq|杀手电话|人報仇|小姐|人绑架|人报仇|麻古|职業殺手|人復仇|人复仇|打手|抽那
賊|民
业|主维权|力
蓝|鲸游戏|鲸死亡游戏|鲸挑战|营|鲸
蛤|蟆
乔|石|伊
宝|来
新|華舉報|约教会|生|疆|唐人|闻办|义安|手訓練營|蜀山|闻网|觀察論壇|生网|黨|天下情色论坛|型汽车遥控干扰器|語絲|语丝|花和尚|華通論壇|缰人|型毒品|疆人七月四日哀悼|金瓶梅迅雷下载|疆分裂|闻管制|版假币销售|華內情|生網|左派|华通论坛|唐人电视台|版假币出售|金瓶梅|华举报|情色海岸线|色界|疆独立|疆国|三才|入网|抗联|声部落|疆國|版假币出手|中囯成立前|義安|聞管制|疆獨|聞封鎖|疆獨立|闻封锁|京报|八荣八耻|疆7.5事件|右派|华内情|观察论坛|版假人民幣|版伪钞qq|聞出版總署|式电警棍出售|中囯成立后|党|世纪新闻网|闻出版总署|版美国秃鹰|版高仿假钱出售|唐神韵晚会
姐|痛|姐口交网|疼
飞|雪|扬论坛|机失事后的云雨
6|4学运|.4事件|4气狗qq|4手枪买卖|4式qq|4式电话|4手槍销售|.26|4手qiang子弹供应qq|4式手槍销售|4手枪子弹供应|4手枪出售|4式订购|4手qiang出售|4式出售|4手槍買賣銷售|.4惨案|4狗qq|4手qiang价格|4手qiang子弹电话|4手枪子弹销售|10办|4运动|4手狗买卖|合彩|4手qiang子彈提供qq|4手枪子弹电话qq|-4tianwang|4手qiang子彈供應qq|4手qiang子彈出售|54改火|4式销售qq|4手qiang子弹提供qq|4手槍子彈供應|4式手枪专卖|4手枪销售|.4.运动|10办公室|4式枪专卖|4手枪子弹提供qq|4手槍子彈出售|4事件|4手枪专卖|4手枪子弹出售|4式图纸|4式手槍专卖|4手槍专卖|4手枪价格|4猎枪買賣出售|4手qiang子弹订购|4手qiang子弹出售|4式出货|9nb.com|4猎枪買賣銷售|4手qiang子彈銷售|4手枪子弹提供|4手槍出售|4式制造|4学潮|4手槍子彈電話qq|4手枪子弹订购|4手qiang子彈訂購|4手qiang子彈提供|4手槍子彈訂購qq|4时期|4手枪子弹供应qq|4手槍子彈提供|4式到货|61661.com|4手槍价格|4手qiang子弹提供|4式手槍出售|4式枪支出售|4手槍子彈提供qq|4手槍子彈供應qq|4手枪子彈供应|4手qiang子彈電話|4手qiang子彈供應|4手槍子彈銷售|4惨案|4手qiang子弹销售|54改装真枪|4手qiang子弹供应
罌|粟
額|爾德尼
許|財利|家屯|信良
肖|强|中特
陪|睡觉|护私人|裸
雅|虎香港
湖|岸哨兵隊長|南省公安厅副厅长偷情酿血案|紧掏|岸護衛兵|岸警衛兵
刻|章|章办证
沃|尔开西|爾開西
n|ng|arcotics|ewsmth.net|arcotic|azi|jgamecollege.org|avn|hzn|ikesong|apolun|acb|eckromancer|pc|ierongzhen|aive|mis|iuniujidi.1174.net.cn|cyh.cn|bfib.cn|inecommentaries|smn
禿|鹰汽枪出售|鷹汽槍出售|鷹氣槍銷售|鷹氣槍销售|鷹氣槍出售
侯|德健
壮|阳保健
泽|d|民|夫
吉|跋猫|岡美穗
痴|拈|迷者|迷练习|迷分子痴迷练习|鸠|捻|乳|鳩
賬|號
战|牌|术军刀销售|术突击刀专卖
两|腿之间|个中国|会|会报道|会新闻|岸关系|岸三地论坛|个待遇|乳之间|国论|岸战争|性狂情
水|去车仑|果冰qq|果冰买卖qq|晶冰出售|果冰出售|果冰销售|扁|利部|果冰买卖|果冰送货上门|胶炸药专卖
心|藏大恶
酥|癢|胸誘惑|穴|痒|胸诱惑|胸
少|女峰|婦偷情|数民族上层人士|修正|妇出台qq|妇白洁全集|妇偷情|儿不宜|儿勿入|女迷奸药水|妇裸聊qq|年大宝全集|妇穴|先队|年阿宾|女迷情药|龙风流未删节版全文阅读|妇包夜qq|女初夜爽片|女初夜|女乱伦av片|妇包夜|年大宝全本|女被插|女迷情粉货到付款|龙风流txt下载|妇|女高潮|妇上门激情|女初夜色片
圮|綦
实|际神
傻|屄|比|吊|逼|b|b靠|子|叉|鸟|鳥|卵
華|建敏|通時事論壇|夏文摘|語世界論壇|岳時事論壇|國鋒|盛頓
踩|江
驶|你公|你娘|你母|你爸|你老师|你老母
屄|屄|屄特寫|儿|裏|友|屄特写|毛
万|税|里|能开锁工具买卖|能麻将机|能开锁器出售|能汽车解码器|维读者论坛|人大签名|能开锁枪出售|晓东|人骚动|人和平上访|能开锁工具出售|能钥匙出售|润南|能开锁器qq|能钥匙专卖|能开锁器专卖|淫堂
持|不同政見|不同政见
执|法犯法
久|久情色
柒|头|西
口|交放尿|爆|射|交|技|交器具|內爆射|活|内爆射|淫|爆吞精|胶
关|卓中
焦|国标
1|t1t.com|3888wg.com|3660233260|代精仿身份证|1xp.1243.net.cn|000scarf.com|73at.com|7da|代個人身份证|8禁入|7173dl.net|3560258484|.3亿|989天安门|8禁色情电影|2590|pondo|2590.0|66578.cn|5wy.com|3ml.net|3423205670|3550515599|8岁以下勿看|6dy-圖庫|8禁成人游戏|8禁a片|夜情|6dy-图库|100y.com|0mb.cn|8岁以下|98964|元假硬币|8禁情色电影|8禁|6大|8摸|7173yxdl.cn|5528236773|代假身份证|31.com|8900.com|3281257753|8禁游戏合集|8岁以下勿入|代假冒身份证|234chengren.1249.net.cn|58le.com|7youle.com|qmsj.com|3687965626
妹|的服务|开苞|妹的屄|妹穴|疼|痛|妹騷圖|妹爽图|妹激情网|妹出售|妹骚图|妹阴毛|妹陰毛
宾|周|馆女郎
毒|龙钻|配方|的配方|品出售|龙舔脚|豺|龍舔腳|品销售|品配方|的制作|品
裙|內偷拍|内偷拍|下风光|下風光
练|功点
液|体炸弹制作|体炸药配方法
轻|舟快讯|松制作原子弹
妓|女|师|院
煉|功
伦|公|功|攻|理三级|理片
黎|安友|阳评
舒|淇|乐安定
遍|地桃花
玉|穴|乳|蒲团|蒲团之官人我要|蒲团玉女心经|女心经|杵|蒲團玉女心經|蒲团之偷情宝鉴|女吹箫
爆|乳娘|乳|炸|竹出售qq|竹专卖|操|草|乳人妻|浆|你菊|炸物|菊|竹专卖qq|菊花|轰|zha|炸装置
叫|床|鸡|小姐|床女优|雞
顔|清標|慶章|射
失|身|身粉
波|胆|霸|霸乳交器具|多野结衣合集下载|波
焚|烧中国国旗
会|计证办理
文|殊|化部|物局|胸|化大革命|凭代办|凭办证|做|革|字狱|字獄|达学
针|孔偷拍|扎|孔摄像机|孔监视器
盛|華仁|雪|华仁
套|牌|现|弄
飯|島愛
極|端武力捕鯨叉专卖|品奶妹|品波神|品波霸|品白虎|品黑絲
捆|绑调教
艳|妇淫女|照|舞淫业|舞聊天室|照门种子下载|照门视频下载|母淫臀|乳|情小说|星|舞|照门
夫|妻多p|妻3p|妻性事|妻亂交|妻自拍|妻俱乐部|妻乱交|妻秀|妻俱樂部
巡|查
滾|那嗎|那嗎b|那嗎錯比|那嗎老比|那嗎瘟比
加|藤
祁|建
绳|虐
领|导新星|跑第五代|导干部王八|养孩子|养宝宝
筹|码
玩|逼|穴
噶|玛巴
卫|星电视接收器|生部
撸|管
乐|酷搏彩中文网|酷搏彩|透乐博彩|趣聊天室
達|賴喇嘛|賴|赖|夫警衛兵|夫侍從|癩
复|员军人|员军官|临安息日会|员军官代表|员军官诉求书|仇了仇|兴党
声|色场所
烟|草局|花爆竹电话|花爆竹出售|花爆竹送货上门|花爆竹批发
沙|漠之鹰销售|漠之鹰出售|比|雪
沦|公|功|攻
组|装枪支买卖|装录音监听软件
h|uashengdun|igh粉送货上门|片|igh粉出货|ujintao|uajianmin|uangsexiaoshuo.1242.net.cn|uihuangtx.com|ttp://www.epochtimes.com|動漫|bv|ypermart|igh粉配方|acking|ongzhi|ttp|acker|eguoqiang|aosilu.com|rw.org|igh粉销售|uangju|eluxiaofu|ost800.com|mtd|eroine|动漫|ypermart.net|exun.com|game|igh粉到货|uzhiming|richina.org|omexf.cn|动画|游戏|entai|站|图|uiliangyu|uanet|aouse.cn|z|漫画|igh粉订购|elong|eroin|aog8.cn|ttp://zhengjian.org|jt|uyaobang|richina|电影|uimin|ao1788.co
煞|笔|筆|逼
韓|聯潮|正|東方
逢|九必乱|八必灾|8必灾|9必乱
违|反购房合同
寇|晓伟
暴|乳|躁的城塔野獸|躁的馬杜克|动|徒|淫|力虐待|奸|亂|躁的警衛兵靈魂|乱|力袭击|干|政|行|幹|風亡靈|熱的戰士|動|力拆迁|力爱国
主|義|席|权|席画像|席李世民|义|攻指揮官|神教|席像
狙|击步枪专卖网|击qiang子弹出售|击汽枪出售|击枪专卖网|击步枪专卖|击枪专卖
毕|业证书代办|业证qq
基|地组织|督教|国|地|督|督教科学箴言报|地組織|恩科
你|色嗎|大爷|媽的|老母|姥|老味|y|奶奶个腿|丫找抽那|妈逼|麻痹|爷爷的|退了吗引发全球|敢上吗|吗b|奶奶|妈的|说我说论坛|娘|爸|色吗|媽比|奶|丫|妈|妈b|好税提供|媽逼|大爺|姥姥的|痴hi左线啊|妈比|妹|媽|媽了妹|爺|妈闭|爷|說我說論壇|他妈|好票提供|姥姥|二大爷|奶奶个雄
帝|國主義|国主义|国幼幼集团军|国夜色
蔣|中正|經國|介石
靖|国神社|國神社|志远
爛|貨|b|逼|比|袋
兴|化：网吧实名制成为民警办案好帮手|奋剂
劝|人
油|行
牧|函
健|卫小口径步槍专卖|卫小口径运动步槍出售|卫小口径步枪专卖qq|卫步枪到货|卫小口径销售|康法|卫小口径步枪销售|卫小口径运动步枪专卖|卫小口径步枪出售|卫小口径步枪价格|卫小口径步槍销售|卫小口径步槍专卖店|卫小口径出售|卫步枪qq|卫步枪订购|卫小口径运动步枪销售|卫小口径运动步枪出售|卫步枪制造图|卫步枪电话|卫小口径步枪专卖|衛小口徑出售|卫步枪出货
亂|倫|交|輪|倫熟女網
短|信号码任意显示|信奖励|信安全关键词测试|信改号软件出售|信改号|信改号软件|信群发|信通知|狗狗粮qq
硬|挺|币批发|币qq|币供应|币出售|直圖騰
肤|白胸大
睪|丸
孟|令伟|建柱
開|山砍刀专卖|苞|放雜志|房
統|獨論壇|戰|獨
段|宜康
庞|建国
九|码|-评|ping|九情色|九情色论坛|霾|城情色|九情色帝国|评共产党|评传保平安|九娱乐|学|评|风|成新|.评|六七六六七二二
钉|子户
甲|庆林|基苯丙胺制作方法|卡西酮配方|慶林|基安非他明|卡西酮出货|卡西酮销售|基苯丙胺制作|基苯丙胺化学|基苯丙胺结构|基苯丙胺合成|基苯丙胺的制作|基苯丙出售|基苯丙胺价格|卡西酮订购|卡西酮送货上门|卡西酮到货
岡|巒|崎美女|村寧次|村秀樹
炸|药制作的方法|彈製作|药看货付款|了证监会|药制作方法|药制造过程|弹制作|弹配方|药配方|弹制造|弹怎么做|掉证监会|药当面交易|药制作完全手册|药|学校|dan|弹的制作方法|弹遥控器制作方法|药制作方法qq|弹制作流程|弹|yao|药制作
敬|国神社
林|慎立|彪|文漪|长盛|佳龙|保華|保华|高樂(收費物品)|肯|業局|昭的灵魂|佳龍|正勝|炎志|业局|高乐(收费物品)|信义|益世|重謨|左鸣|树森|正胜|重谟|長盛|信義|樵清|昭纪念奖|郁方
晚|年周恩來|年周恩来
佔|領中環
刺|刀专卖网
兒|子
践|踏法轮功
砂|光甩刀qq
按|摩棒|摩|照马雅历法|摩小姐兼职|摩女上门服务qq
速|效迷奸药
辣|妹包夜|妹聊天室
貝|尤爾|爾求生刀专卖
鷹|眼派氏族|飛淩軍刀专卖
月|經|经|经不调
首|长|長
蘿|拉
押|大|小
盧|卡|西德
敏|主
翻|案
觉|者
楼|凤qq
肛|门喷水|门|門噴水|門拳交|jiao|栓母狗|插|恋|交|门拳交|屄|門|胶
绵|恒
搔|穴
买|猎枪|卖进口硅胶人皮qq|卖易容面皮qq|77式|假钞|卖猎枪子弹|凶|卖胡椒醛|卖人造脸皮qq|卖硅胶面皮qq|卖高仿人皮面具qq|手机改号软件|卖乳胶脸皮qq|卖汽车拦截器|假身份证|财富|卖盐酸氯胺酮|卖高仿真人皮qq|春堂|卖肾|卖自制枪支|卖氯胺酮|卖身份证qq|卖自制手槍|卖人皮面具qq|卖新版假币|砒霜|卖高仿人皮qq|手枪|卖高仿真面具qq|卖人皮面具|铊盐|乌头碱|卖雙管獵槍|断职工|卖乳胶人皮qq|氰化钾|卖眼镜蛇弩|卖苯基甲酮|卖仿真脸皮qq|卖高仿脸皮qq|卖天然咖啡因|春网站|手机窃听软件|卖气枪|卖人造面皮qq|卖假证|卖甲基苯丙胺|假币|仿真枪|卖盐酸羟亚胺|春军团|卖假币|卖氰化钾|卖54手槍|卖手狗|银行卡qq|卖仿真人皮qq|氰化钙|冰毒|肝臟qq|卖77手槍|卖64手槍|麻醉枪|眼角膜|卖硅胶人皮qq|卖92手槍|卖高仿面皮qq|发票|卖假钱电话|卖枪支|卖54枪qq|卖手枪|54手枪|腎源qq|卖乳胶面具qq|卖台湾版假人民币|卖麦角醇|住宿发票|卖易容面具qq|卖硅胶面具qq|断工龄|卖高仿面具qq|枪|凶杀人|卖小冰砖|卖枪qq|卖左旋麻黄素|卖可可精|卖高仿真面皮qq|卖高仿真脸皮qq|卖假钱|春|卖万能开锁工具|藏刀|卖易容脸皮qq|卖进口硅胶面皮qq|卖仿真面皮qq|卖仿真枪|真文凭qq|卖77式手枪|卖仿真面具qq|卖冰毒qq|了个婊|假币qq|卖黄麻素|卖易容人皮qq|卖大冰砖|肾信息|卖硅胶脸皮qq|卖进口硅胶脸皮qq|卖乳胶面皮qq
互|舔淫穴|淫|联网审查
薇|瑞恩
仇|共
志|洪李|愿兵
麒|麟文化
贯|通两极法
眯|眯俱乐部
色|情动漫|情五月天|色成人|魔|界网|情影视基地|情游戏|情成人网站|中色社区|逼|情网站|情久久|图片网站|色淫情网|色婷婷|悠悠成仁|猫影院|情武侠小说|中色地址|情工廠|色电影网站|狼友综合网|情裸聊|情论坛|诱影院网|老头|貓|狼論壇|情在线电影|一色|老妈|欲|友|情电影|色岛|电影|97爱|情服务|哥哥影院|中色|淫|界|区|书库|區|窩窩|片免费下载|吧社区|老汉导航|色|迷城|窝窝|情草榴社区|狼谷超级色站|上色导航|播电影网|友霸三国全文|中色成人影院|狼五月天|情|b|性|狼小說|播成人|情无码|域色吧|狼论坛|狼小说|情工厂|情成人游戏|之戒四合院|97愛|情武侠|女露点|狼居|情直播室|情三级片|图|猫|盟|吧亚洲|情聊天室|人阁成人影院|狼谷|情文學|書庫|情成人聊天|狼网址导航|情电子小说下载|bb吧|婷婷|色五月天|诱|狼|狐狸網址|bb吧综合|站导航|狐狸网址|誘|情小电影|情論壇|情游戏下载|情三级
妻|色网
柴|玲|契爾
窃|听|听器|听神器|听器材|听软件
槍|支彈藥|支弹药出售|支出售|支买卖|qq
抿|主
粮|食局|荒
m|m上门服务|m收费视频|t-虎牙专卖|m屄|eideweijiefu|y3q.com|inghui.cc|akesi|m一夜情视频|dma|m美圖|m裸聊|aking|inghui|eiguiqingren.1274.net.cn|oyi520.cn|ayingjiu|ultimedia|m视频裸聊|3长刺专卖|inghuinews|inghui.ca|m裸聊qq|9-d80軍刀专卖|aozedong|okeer|ajiajue|ohanmode|osuolini|gjzybj.com|pceggs.cn|9长刺专卖|andela|orphine|92f式手槍买卖|9军刀专卖|m美图|aster|ai骚|m兼职服务
东|突厥斯坦|土耳其斯坦|西南北论坛|突独立|条英机|热空姐|方闪电|伊运|南西北论谈|条|突暴动|京热合集|京热|北独立|突组织|院看守|土耳其斯坦信息中心|方时空|突伊斯兰运动|升|突暴动和独立|正教|方红时空|京热视频|京热种子|京热无码电影|方闪电；|突厥斯坦民族革命阵线|洲|京热视频下载|北xx网|突厥斯坦伊斯兰运动|社|突联盟|亚|京无码下载|京热bt|亚病夫|突|方红
寂|寞自摸|寞女|寞男|寞少妇裸聊
巅|峰体验
永|恒之塔
屁|眼|股|精|穴|民
7|7手枪价格|7式手槍销售|5暴行|.4中山公园|7猎枪出售|7手qiang子弹供应qq|7手枪子弹电话qq|7手qiang价格|7猎枪買賣銷售|gg|7手枪出售|7手槍销售|7手槍出售|7手qiang子彈供應qq|7手槍子彈供應|.310|7手狗买卖|7手槍价格|7bbb|大军区|7手槍子彈供應qq|7手枪子弹供应qq|7手枪子弹提供qq|7手槍子彈訂購qq|7手槍子彈電話qq|7手枪销售|7手枪54手枪64手枪|mmo.com|1ka.com|7猎槍出售|7手qiang子弹提供qq|7手槍子彈提供qq|7枪支出售|7手qiang子彈提供qq|7手槍专卖|7手槍買賣銷售|7式枪出销售
汽|车万能钥匙|狗出货|车遥控解码器|枪制造图纸|槍出售|狗喷子|车信号干扰器|车万能解码器|狗批发|车炸弹制作方法|狗销售|枪专卖店|车遥控器干扰器|狗qq|车解码器干扰器|车专用解码器出售|车炸弹|槍买卖|枪铅弹销售|车遥控解码专卖|车遥控解码器供应商|车干扰器|狗专销|枪原理图|车中控干扰器|枪货到付款|狗支付宝专卖|车解码器价格|车防盗干扰器|车电脑解码器|油短缺|狗出售|狗专卖|车解码器联系qq|枪买卖|枪出售|车遥控干扰器出售|狗订购|车开锁器销售qq|车解码器供应|车遥控解码器出售|车遥控拦截器|狗电话|狗到货|狗制造图|车拦截器|狗网|车拦截解码器|车解码器直销|车解码|车遥控干扰器
疆|独|獨
双|管猎枪专卖|管猎枪销售|管猎槍买卖|腿间的禁地|臀|证|十节|管猎狗专卖|管猎槍出售|管平式枪出售|管猎枪出售|龙入洞|峰|规|管猎槍销售|轨|峰微颤|腿叉开|管立式猎枪|管猎枪
聊|性
杀|人犯|你全家|你一家|手|人|b|毙|人党|手雇佣网|人放火|杀杀|手雇佣网qq|手替人报仇
屌|我|女也|七|西|鸠|爆了|毛|你|妳|他|人也|她|7
叔|嫂肉欲
事|實獨立
税|点低|务代|金优|务发票销售|票代理|据代开qq|点优|率低|号码改13|票|票代理有限公司|查验|率优|金低|后付款|点优惠|率优惠|务总局|务代理开发票|上网|票代开
赶|快取款|你娘
【|明慧网】
牛|頭馬面|顿|头马面|逼|比|埔帮|b
十|字军|八和谐|九年前|月飞雪|三兄弟帮|年动乱石进|七年|六大|足十恶|二煞星帮|字开锁器专卖|7大|八大|周年|二个春秋|八岁以下|八摸|七大
飛|揚論壇
兆|赫
束|缚
悔|过书
盐|酸羟亚胺送货上门|酸去氧麻黄碱电话|酸羟亚胺qq|酸羟亚胺合成|酸羟亚胺配方|酸羟亚胺出售|酸氯胺酮制作qq|酸羟亚胺订购|酸羟亚胺电话|酸羟亚胺出货|酸羟亚胺到货|酸氯胺酮批发
瘟|b|比|家宝|家|假鸨|家鸨|家寶
兩|個中國|會|會報道|會新聞|國論|岸關係|岸三地論壇
喝|血社会
中|华抗日同盟|國威脅論|国报禁|国气狗商城|國社會進步黨|控拦截器|華人民共合國|华民国|朝翻脸|共伪政权|办发|gong|国弓弩直销|國孤兒院|苏边界争端与武装冲突|功|華時事|国政f|华人民共合国|国成人论坛|國移動通信|華民國|华时事|国威胁论|山公园哀悼|國復興論壇|國猪|華養生益智功|央社|共暴政|国移动通信|年美妇|俄邊界|珙|華大地|国教徒|南海厚黑学|共下台|国新民党|国铁血党|国气枪网|国猪|央電視臺|俄边界|华联邦|条美華|共黑匣子|国的陷阱|國論壇|國真實內容|國之春|国zf|国真实内容|文搜性網|华大地|毒圖騰|國問題論壇|華人民實話實說|國和平|俄密约|国问题论坛|国恐怖组织|国自由党|国民间保钓联合会|國性愛城|国和平|文搜性网|国时报|野千夏|华大众|华局域网|华人民实话实说|国弓弩狩猎网|央电视台|華講清|纪委|央zf|央日报|央领导|國共產黨|国性爱城|共十八大|国复兴论坛|国之春|华讲清|国当局|国弩弓专卖|国军刀网|國共産黨|国改革年代政治斗争|奖|国社会的艾滋病|共的|共独裁暴政|越自卫反击战|国民主党|共|特|国的人权|華真實報道|国社会进步党|国军刀出售网|国科技需要根本改变|国公民|国论坛|華人民正邪|国孤儿院|国社会论坛|港|澳|共独裁|国特工|國成人論壇|國社會論壇|南海斗争|华民国；|宣部|华人民正邪|国国家防火墙|年美婦|国气枪销售|天|局|俄边界新约|華大衆|华大陆行政执事站|國豬|華人民共和國|央政法委|华真实报道|华养生益智功|国人权|天一气功|毒的圖騰|南海|华帝国
妩|媚挑逗
联|合起诉最高人民法院|总之声|易互动|合国大会|总|合后|名信|合签名|名上书|总之声传单|大|易|合国
物|品
叶|菊兰|剑英|子楣
先|奸後殺|奸后杀|进性|天健康法
崗|哨士兵
呂|京花|秀蓮
亮|屄|穴
刑|警
麗|春苑
回|汉纠纷|良玉|回|民吃猪肉|族|民|民是猪|民暴动|民吃豬肉|教；|教|民暴動|族人吃猪肉
豐|饒的果實|唇豔姬
株|连
丢|你老母
１|８歲淫亂
長|官沙塔特|瀨愛|瀬愛
搞|死|个处女|你
曲|线消魂|線消魂
留|园网
給|你爽
逗|比
輿|論|論反制
午|夜凶铃|夜淫虎网|夜激情片|夜爽片|夜激情
锡|纸开锁教程
單|管平式出售|管獵狗出售|管立式出售|管獵槍出售
现|代逍遥录|金百家乐|金斗地主|代情色小说|在支票|金|金棋牌|役电警棍出售|金梭哈|金券|世现报|金交易|代激情
卓|伯源
蓮|花逼
矯|健的馬努爾
刀|具直销网|具专卖qq|具交易网|具货到付款|具专卖|具专卖网|剑批发网
夏|川纯
機|巴|掰|芭|ｙ|8|y|八|叭
瑞|典fallkniven軍刀专卖|典fallkniven军刀专卖|士金融大學|士金融大学
復|仇了仇
扒|穴|屄
頭|領奧馬|領墳墓管理員
滚|那吗|那吗b|那吗错比|那吗老比|那吗瘟比|粗
白|虎嫩b|虎小穴|浆四溅|立樸|军|牙签验货付款|粉买卖|牙簽到货|皮書|色恐怖|粉销售qq|牙簽销售qq|牙簽销售|虎少妇|粉出货|嫩|痴|粉订购|莲教|液四溅|夢|春礼|蓮教|嫩騷婦|立朴|牙签电话|牙签出售|冰黄冰qq|牙簽出货|牙签到货|小姐特码|皮书|虎少婦|牙簽送货上门|粉销售|秀华|漿四濺|小姐马报|牙簽订购|粉送货上门|液四濺|领裸聊|牙签订购|粉|粉到货|刃刺刀|虎陰穴|牙签出货|牙签销售qq|牙签配方|粉卖买|虎阴穴|嫩骚妇|粉配方|牙簽配方|牙签送货上门|粉；|梦|粉海洛因|牙签合成
赖|昌星|达|士葆
凌|辱|锋
菱|恝
牌|九
俞|正聲|正声
路|易|甬祥
費|鴻泰|良勇
龜|兒子|公|孫子|頭|投
遠|志明
简|肇栋|易炸药制作工艺|易制作c4炸弹教程|鸿章|易炸药制作|易原子弹制作
吳|方城|仁華|百益|幫國|志芳|儀|官正|敦義|弘達|學燦|學璨|育升|邦國|宏達|淑珍
贪|官|污腐败
2|o年|22se圖片|代個人身份证|22se图片|feiche.cn|011高考落榜名单|代假身份证|代假冒身份证|代精仿身份证|1世纪中国基金会|02333.com|0和谐年|011最新汽车解码器|08.43.198.56|011考生名单出售|011最新版假钱出售|011汽车万能解码器
瞞|報
解|放军|放tw|放台湾|码器专卖qq|码器出售|放軍現役軍刀专卖|放前|放后
眼|角膜价格
硅|胶仿真人皮面具|胶人皮qq|胶人皮货到付款|胶脸皮qq|胶面具货到付款|胶脸皮货到付款|胶面皮qq|胶面具qq|胶面皮货到付款
從|後插入
陰|莖插小穴|户|茎|屄|部特寫|戶|水|部|唇|莖|精|門|囊|核|締|穴新玩法|道|道圖片|阜高聳|阜|穴|蒂|毛
皮|箱炸弹|箱炸弹构造|条|拉德|条客|條客
婴|儿汤
合|成氯胺酮|成氯胺酮qq|成k粉|成冰毒|采开奖|彩|彩开奖|一共融|成盐酸羟亚胺
妳|妈的|娘的|马的|老母的
革|命
系|統|統公告|统讯息|统|统公告
庭|院警衛兵|审
时|劝人三退劝三退劝世人|事参考|事论坛|代论坛
嘌|据
论|功|攻|坛管理员|公
奥|巴马|马尔
诱|奸|惑爽图|人美眉裸聊视频|惑电影|人双峰|色uu|惑视频
护|士爽图|士诱惑|法|士资格证办理|士证办理
齊|墨|諾
头|目
近|亲相奸|親相姦|親相奸
泼|妇
都|市缘
洛|克菲爾特
酒|店援交|店急聘|店发票出售|店特殊服务电话|店发票qq
线|上投注|上娱乐城
观|音法门|世音
抽|插|差|水|一插|你|插呻吟|头|你丫的|頭|插仿真器具
邵|家健
骇|客
氰|化钾出售|化钠出售|化钾的制备|化钾供应qq|化钠供应|化钙供应|化钾供应|化钠批发|化钾出售qq|化金钾价格|化金钾买卖|化氢出售|化镉供应|化碘供应|化钙价格|化银钾供应|化金钾供应|化钾批发|化钾药物出售|化汞出售
废|统
吞|精|精骚妹|精騷妹
外|蒙|交部|专局|$$挂|~~挂|—挂|$挂|挂|交論壇|交與方略|交与方略|掛|/挂|@挂|交论坛|\\挂|来工协会|_挂|-挂|~挂|汇局|@@挂
劉|賓雁|華清|俊國|士賢|永川|延東|千石|青|文勝|文雄|曉波|伯承|賓深|剛|國凱|山青|曉竹|淇|少奇|凱中|雲山
鎮|壓
後|庭
四|川独|级答案|二六社论|川獨立|川獨|人幫|川仁寿警方冲击省人大抓上访者|房播播|人帮|事件|海帮|川独立|步行动|风|无目标
抑|制剂|制劑
丁|香成人社区|香成人色区|元|关根|子霖母亲|香成人社区网|香成人|香社區|香成人网|香花成人网站|香岛聚色导航|香社区|關根|一平|子霖|香五月天最新网址|字裤翘臀|字裤|子霖天安门|字褲翹臀
鋸|齒通道被遺弃的骷髏|齒通道骷髏
強|暴|姦|制浣腸|姦處女
旅|馆自拍|游局|館自拍
砲|友
川|岛和津实|島和津實
乌|克兰亲俄武装|克兰民兵武装
追|债|查国际|踪设备
迅|雷日本无码
発|妻|射
戴|相龙|秉国|维教|晶|红|海静|維教|相龍
轉|化|法輪
週|六性吧
砷|化氢出售|化物供应
石|化圖騰|拳戰鬥兵|戈|肖
倒|扁|卖军火
採|花堂
规|模冲突
品|穴|色堂|香堂|色堂网址|色堂论坛最新地址
哒|赖
长|期出售发票|期銷售54手槍子彈|期销售甲卡西酮|期供应麦角酸|期供应奶油冰|期收购人体器官|期供应三唑侖|期办理|期供应54手槍子彈|期批发摇头丸|期销售海洛因|期销售小冰磚|期销售水果冰|期供应king粉|期供应水果冰|期销售左旋麻黃素|期销售high粉|期收购眼角膜|期销售乙醚|期供应海洛因|期供应冰毒|期供应冰钻|期销售三唑侖|期销售搖頭丸|期销售青蒿素|期供应high粉|期供应乙醚|期供应甲卡西酮提|期供应胡椒基甲酮|期供应间苯三酚|期供应麻黄素|期供应发票|期供应医疗发票|期销售麻黃素|期销售胡椒基甲酮|期供应麻谷|期供应神仙糖|期供应摇头丸|期销售大冰磚|期收购肾源|期低价供应子弹|期提供制作鉆石原料|期销售麻古|期销售氯胺酮|期供应左旋麻黄素|期供应白粉|期供应冰砖|期销售神仙水|期供应麻古|期供应黄牙签|期供应白牙签|期供应小冰砖|期出售银行卡|期供应迷魂粉|期销售冰磚|期销售king粉|期销售麥角酸|期销售間苯三酚|期代办|期收肾|期销售k粉|期销售冰鉆|期供应k粉|期销售各种枪l支|期供应肾源|期提供54手槍子彈|期销售黃牙簽|期供应神仙水|期供应氯胺酮|期供应钻石|期供应大冰砖|狗专卖|期销售白牙簽|濑爱|期销售白粉|期销售神仙糖|期销售鹽酸羥亞胺|期供应黄体酮|期供应摇头糖|期供应青蒿素|期供应四氢吡喃酮|舌象|期供应藏刀|期销售奶油冰|期销售搖頭糖|期销售麻谷|期供应盐酸羟亚胺
霍|比预言
圣|女峰|战；|母|母峰|火|战组织|母白莲花|战|泉学淫
太|石村|垃ji|监|神|阳城网上娱乐|子党|監
立|式双管猎枪出售|式双管猎出售|式双管枪销售|委|法院|法委员|木愛迅雷下载
黨|主席
塔|內|烏|内|乌|利班
莖|候佳陰
呼|喊派|i|吁书
茅|厕洞
拉|姆斯菲尔德|皮條|丹|sa|姆斯菲爾德|登|萨|卜楞寺|斯维加斯|皮条
股|民电话资源qq|民资源qq|民电话资源
臭|你|妳|她|女也|７８|作|逼|他|gy|七八|78|名昭著的|街|人也|gｙ|化西|化|傻
狡|猾的達夫
纪|元
獵|qiang子彈提供|qiang子彈出售|槍子彈訂購qq|槍子彈銷售|qiang子彈訂購qq|qiang子彈訂購|頭者出售|qiang貨到付款|槍制造图|槍手槍出售|槍出售|qiang子彈銷售|槍子彈出售|qiang子彈電話|槍麻醉槍出售|qiang子彈供應qq|槍子彈提供qq|qiang出售|槍銷售|枪出售|qiang子彈大量供应|qiang子彈提供qq|槍子彈供應qq|槍子彈供應|狗出售|qiang銷售|qiang子彈供應|槍子彈提供
卢|西德|卡
额|尔德尼
東|方紅時空|社|升|西南北論壇|突|京熱|洋屄|方時空|土耳其斯坦|院看守|亞病夫|北獨立|南西北論談|條英機|突暴動|亞|部地下水路|條|突獨立|正教|熱空姐|北xx網
擦|你妈
增|值税发票联系电话|值税发票联系qq|值税发票代开
宿|费发票|费发票qq
苏|菲尔|拉|南成|盈铃|晓康|树林|贞昌|家屯集中营事件|家屯|绍智|盈贵
裸|陪|聊|聊妹|足腳交|聊美女|聊妹妹|聊俱乐部|图|体聊天室|聊性伴侣|體|体少妇|露自拍|聊美女qq|体激情聊天|身玩自摸|聊论坛|照|体|體少婦|聊交友|聊网|聊视频|照图片|露|聊qq|聊网视频|聊视讯妹妹|聊聊天|聊交友俱乐部|聊激情|舞视频聊天室|体衣裤透视眼镜|聊做爱表演|体陪聊|体聊天|聊表演|聊网站
电|话改号软件|话改号|话92手qiang子弹|警棍专卖|话64手qiang子弹|视流氓|话用户|警棍出售qq|狗仿真枪|警棍出售|影色情|监会|购数据|警棍货到付款|话64手枪子弹qq|话步qiang子弹|话猎qiang子弹|车之狼|警棍厂家直销|驴一本道|警棍批发
缘|圈圈
西|尔艾力|班牙奥托军刀专卖|藏国|z|藏人权|藏天葬|藏獨|藏3.14事件|藏國|藏之歌|藏|藏独立|藏分裂|臧|藏獨立|藏流亡政府|哈努克|藏自由|藏314事件|北帮|葬|班牙奧托軍刀专卖|脏|奘|独|藏局势|班牙苍蝇水|洋美女
璩|美凤|美鳳
精|品折刀系列|品直刀系列|液榨取|液浴|神控制|神病|童|鹰汽狗专卖网|子|液|神药品|童欲女|品电影
桃|园蜜洞|井望|園蜜洞
稠|的精液
绿|营|色环保手机|茶婊
饭|岛爱
貞|操
严|家其|家祺|禁词|方军|家淦
廁|奴|所偷拍|所盜攝
代|理个性号码变号业务|购flexispy增強版|人報仇|開醱票|人制造意外死亡|理個性號碼變號业务|理指定號碼變號业务|表性|理假发票qq|开服务费|開普通增值稅發票|购007間諜免費版|理税票|开发嘌|办各类证件|办免考驾驶证|人出氣|开服务发票|办警察证|制1代精仿身份证|购手機間諜|购潛伏者專業版|办各种真实文凭|开|做发票|開销售發嘌|制假1代身份证|制一代假身份证|开住宿費发票|制壹代假冒身份证|购潛伏者手機監聽軟件|理假币|办大本文凭|办醱票|理增值税发票|开广告费发票|开国际货运发票|办国外毕业证|制假一代身份证|开旅馆发票|考|开正规发票qq|開發嘌|开地税发票|办教育文凭|理任意號碼變號业务|开优惠发票|辦各类證件|開各类发票|制壹代假身份证|制假身份证|办各种证件qq|理台湾假币|开增值税醱票|理真实文凭|開普通商業發票|制假身份證|办全国毕业学历|开咨询发票|制假二代身份证|制假2代身份证|制假冒身份证|购007間諜破解版|购007間諜專業版|办各种证件|购潛伏者免費版|制假2代身份證|办各类文凭|理指定号码改号业务|购007間諜改良版|购007間諜最新版|开做账发票|办英语等级证|开餐饮发票|制假冒二代身份证|理指定号码变号业务|制假二代身份證|制假冒二代身份證|人報復|办国外文凭|开普通发票|开国税发票|办各种|考假证|购007間諜增強版|购手機007間諜軟件|人报仇|办会计证|理任意号码改号业务|开旅行发票|开建筑发票|理开发票|办驾照|办各类公证|开酒店发票|购手機碟中諜軟件|购007间谍专业版|开定额发票|理假发票|办假学历qq|开正规發票qq|办学位证|开住宿发票|开广告发票|开发piao|开电话发票|制1代假冒身份证|制2代精仿身份证|人出气|办文凭qq|开建筑工程发票|办真实文凭|办证qq|制1代高仿身份证|办学士学位证|开保真发票|开各类发票|理税率|开道路交通发票|制假冒壹代身份证|购flexispy免費試用|购007间谍免费版|理发票|购007間諜免費試用|开税务发票|开普通商品销售发票|办大学毕业证|开出租车发票|办身份证|制假冒1代身份证|制二代假身份证|开机打发票|开运输发票|制假冒一代身份证|办正实文凭|制2代假身份证|开税票|办假学历|开商品发票|开避税发票|制假冒一代身份證|理手机改号业务|购潛伏者增強版|办驾驶证|开餐费发票|开咨詢費发票|办国外学历证|開增值稅發票|理短信改号业务|制2代高仿身份证|购手機竊聽軟件|理手機改號业务|开正规發票|办武警驾驶证|开建材费发票|开工程发票|制假壹代身份證|制壹代高仿身份证|购flexispy專業版|开增值税发票|开发票qq|办员|开发票电话|开假发票|理彩信改号业务|人了仇|制二代精仿身份证|开房租发票|开发漂|开租赁发票|开定額餐飲发票|制二代高仿身份证|制一代假冒身份证|制假壹代身份证|开税票qq|理朝鲜假币|開专用发票|制二代假冒身份证|购手機007|理短信改號业务|理彩信改號业务|制假冒壹代身份證|办文凭|制一代精仿身份证|制假冒2代身份证|制1代假身份证|购潛伏者免費試用|办美国文凭|购潛伏者破解版|开医疗发票|开會議費发票|制假冒身份證|开醱漂|购flexispy免費版|開各类票据|开fapiao|办外国文凭|制一代高仿身份证|购潛伏者改良版|制假1代身份證|人报复|购007间谍破解版|办国外文凭认证|理|开发票|删负面贴子|制2代假冒身份证|制壹代精仿身份证
豔|情小說|舞淫業|乳|照|婦淫女
昏|迷圖騰|药
淋|病
弘|法|扬大法
泛|绿|蓝
温|爷爷|jia宝|馨|公子|如春|假饱|加保|加宝|加饱|宝宝|总理|家保|b|x|元凯|逼|云松|夫人|比|切斯特销售|切斯特出售|家宝|jb
童|颜巨乳|增|屹|顏巨乳
網|禪|特
於|幼軍
预|测领导人|订54式
余|英时|传琮温家|英時|秋雨
退|出共党保平安|伍兵杀手|共党|党保平安|dang|出共产邪党|伍兵打手|党|伍军人
订|购盐酸羟亚胺|购步枪子弹qq|购步枪子弹|购54手枪子弹|购步qiang子弹|购猎qiang子弹|购手qiang子弹|购氯胺酮|做人皮面具|购猎枪子弹qq|购手枪子弹|购大冰砖|购苯基丙酮|制人皮面具|购水果冰|购64手枪子弹|购92手枪子弹
间|苯三酚配方|苯三酚送货上门|苯三酚订购|苯三酚出货|苯三酚到货
欽|本立
反|封鎖|抗军哨探兵埃特万|抗軍哨探兵埃特萬|抗軍偵察兵埃斯萬|动|宇宙|社会|封锁技术|政府|共|社會|抗|分裂|抗军|抗军侦察兵埃斯万|中游行|人類|共复国|华暴动|革命|party|和谐|腐敗論壇|华|日|人类|封鎖技術|右运动|黨|党|腐败论坛|右题材|对|攻|对磁悬浮|恐委员会
司|馬晋|馬璐|马晋|马璐|有代票|有代税|有开税|法部门|法部|法院|有开票|法警官|马系列气狗出售|徒華|徒华
光|伴我淫|复民国|辉形象
收|购高考考生信息|购肾脏|费删帖|养孩子|复台湾|爹|容所|单管猎狗|养宝宝|费清理负面信息
丫|頭養的
好|色cc|嫩
綿|恒
推|油|背图|翻中共|翻共党|bei图|翻共产党|翻中国共产党
骯|髒美學
郝|伯村
空|白磁条卡|难黑匣子|气精灵|虛之地|难|劲功|難|姐性交|氣精靈|虛的伊坤
潑|婦
今|码
淪|公|功|攻
理|想信念斗争
i|9game.com|d666.uqc.cn|sing99.com|sil|2590|p17908|ncest|ce|tnongzhuang.com2y7v.cnhwxvote.cn|eboy.cn|sis|tem|cpcn.com
廉|政大論壇|政大论坛
虛|弱圖騰|無的飽食者
邱|垂贞|太三|毅
聖|戰|母|泉學淫|射手
哭|爸|母
去|中央|死|氧麻黄素配方|氧麻黄碱制作方法|你妈的|你媽的
咬|着龟头|著龜頭
经|文|社理事会|济社会理事会|血|典三级片|典成人电影|典炮图
萊|特
吗|啡片|啡碱|啡|的
机|叭|掰|ｙ|要费|打发票代开|八|巴|芭|y|8
秘|裂|密花园|部|處|肉|唇
御|の二代目|花王朝|花王
涵|涵
任|意改号码|意号码变号|意号码软件|意显号软件|意修改主叫号码|意改号码qq|意改号|自元|意显软件
列|宁|确|寧
疯|狂施暴|插港姐|狂抽送|狗
汪|东风|东兴|兆钧上书|兆钧致胡温公开信|笨湖|岷|兆钧|洋|東風|苯湖
腎|源价格qq|源供应|臟中介|源价格|源出售|源出售qq|脏中介|臟价格qq|臟供应
嘻|游中国|遊中國
瑪|麗亞|雅|雅網
鸽|派
颜|庆章|射少妇|射|射自拍|骑|均|色革命|清标
草|擬媽|榴成人导航|榴社區|榴社区最新网址|逼|他|泥马|你丫|的你妈|拟妈|死你|榴社区最新地址|她|你媽|你吗|你妈|莓牛奶|妈|死
儂|著岡巒|著卵拋
兼|职|职小姐qq|职女上门|职妹妹上门|职女上门服务|职女上门qq|职楼凤qq|职男妓|职援交|职小姐上门|职妹妹上门服务|职小姐上门服务
英|国金融时报|语四六级答案|雄纪念碑|国骚本气枪出售|国骚本订购|国b5供应
遥|控干扰器货到付款|控解码器联系qq|控干扰器价格
有|票开|hi啊|容奶大|病睇兽医啦|仑啊|偿换肾|偿肾服务|偿献肾|纯古出售|码性爱|偿捐肝|偿捐肾|码片|碼
殺|你全家|你一家|人犯|人
则|民
无|抵押贷款|码动漫|码长片|毛美少女|能|官正|界浏览|界浏览器|码av|码成人|帮国|界|码做爱|码性爱|码精品|码片|邦国|帮过|网界|码动画片|毒av影院|修正|码淫漫|界网络|码|码体验|码丝袜|码淫女|毛|码快播|码ａ片|码直接下载|码炮图|套自拍|息贷款|码光碟|锡锡锋牌汽枪|码无套|码彩图|网界浏览|码写真|码内射|套内射|码精选
凱|爾本|爾雷斯|特切爾|奧勒尼什
凯|他敏|奥勒尼什|尔本|尔雷斯|特切尔
黑|车|牛豆奶|客|丝熟女|市军刀专卖|毛屄|屄|社會|教|枪|恶势力保护伞|火药的制作方法|市刀具qq|白无常|手黨|暗小屋|手党|白無常|索金供应|逼|庄|火药|社会|瞎子岛
木|子论坛|子論壇|仓|犀地
牝|户
热|那亚|比娅|站政论网|武器qq
戈|博专卖|瑞爾德|揚|扬|瑞尔德|博gerber軍刀专卖
财|税有限公司|税代开发票|力物力|政部|税代理公司qq|税代理公司|务代理公司
矢|泽种子
冬|季热|季熱
貫|通兩極法
了|仇
土|制c4过程|炸弹合成方法|匪政府|匪政权|制c4|炸弹qq|炸弹制作工艺|g|共
党|主席|魁|产共|天下|文化|棍官僚|的喉舌|禁|章|鞭|纪委|保平安
竹|联帮
d|alai|afa|l.com|ajiyuanepochtaiwan.net|engxiaoping|amn|ongtiaoyingji|ick|ingxiang.1243.net.cn|a选|9军刺军刀|ulumen|adati.com|ownloader|ajiyuan.com|l喇嘛|iy原子弹-专家|ang|ajiyuan|pp|uowan|igitallongking.com|iamorphine|olbbs.com|666.com|i制|ishun|alailama|fdz|ingxiang.1249.net|uowan.com|iacetylmorphine
膏|藥旗|药旗
橋|侵襲兵
玛|雅网|雅语言|丽亚|雅|雅论坛|拉戈壁
蝴|蝶刀专卖|蝶刀专卖网|蝶刀专卖qq|蝶刀批发|蝶逼|蝶甩刀出售qq|蝶甩刀专卖qq
斯|普拉特利群岛|大林|諾|皮爾德|诺|蒂芬·霍金|皮尔德
摇|头丸送货上门|头丸出售|奖|头玩|头丸合成|头丸订购|头糖订购|头丸|彩|头丸价格|头糖合成|头糖出货|头丸到货|头丸出货|头糖到货|头丸配方|头糖配方|头糖送货上门
超|毛大鮑|高清成人电视棒|级性虐|女也|gy|gｙ|78|越红墙|他|她|跌股|强解码干扰器|你|七八|级公子|高压电警棍出售|妳|人也|７８|毛大鲍|爽
鹰|眼派氏族|飞凌军刀专卖|派
驾|照代办|驶证代办
蜜|穴|洞|液|唇|壶
v|oa|oachinese|ip886.com|网|oa.gov
（|恐怖）袭击|2001）3号文件|1993）政联字1号文件
阿|拉法特|旺晋美|普唑仑|鲁纳|扎特|罗约|扁萬歲|巴斯|鲁纳恰尔|拉|茵斯塔|萊娜|共|拉伯|鲁纳恰尔邦|克塞钦|彌陀佛|扁|扁万岁|弥陀佛|芙蓉|波罗网|羅約
舔|舐|下面|b|脚|奶|西|便|屁眼|雞巴|xue|遍|穴|鸡巴|肛|弄|批|吮|花苞|逼|屄|阴|腳|阴自慰器
鮑|威爾|戈|彤|伊
蒲|团
幫|人追債|人出氣|人勒索|人討債|人綁架|人被欺負|人處理恩怨|人消災|人清債|人敲詐|人殺人|人砍人|人打架|人专业勒索|人毀容|人了仇|人報復|人制造意外死亡
昝|爱宗
赵|四眼|洪祝|氏猎鹰销售|南|总理|式眼|子扬|子阳|式扬|建铭|紫阳|品潞|晓微|海青|乐际
錢|達|國梁|其琛
團|長戈登|員馬爾汀
滥|比|货|b|逼
餐|饮发票出售
菊|花蕾|花洞|穴|门|花穴
遺|精
您|好税提供
孤|岛情色王朝
狗|誠|养|乘|娘|草|日的|日靠|比|产蛋|屁|卵子|b|屎|日|娘養的|養|诚|城|成|剩|操|狼養的|雜種|卵|娘养|杂种
熟|妇|婦|女顏射|女性交|女俱乐部|女颜射|女|母|女護士|女亂倫|女乱交|婦騷器|女乱伦|妇人妻|妇骚器|女护士|婦人妻
蘭|迪|博求生刀专卖|博3號軍刀专卖
铃|木麻|木麻奈美
俗|人岛
隐|窝窝|形喷剂|形汽车牌照
静|坐
项|小吉|怀诚
菅|野亚梨沙
购|买枪支|买假币网|买假币qq|买迷幻药|买气枪专卖|买各类考生信息|买qiang支|蒙汗药|买各类考生信息qq|买考生名单qq|钓鱼岛|买xwodi|买学历证|买槍支|买秃鹰气枪|买银行卡|买考生名单|买假币
钱|还没存|还没汇吧|达|其琛|国梁
社|會主義|会不公|会黑暗|hui主义|会主义灭亡|科院
挡|中央
恰|尔
六|四事件|百度四|。四|合兵法|月联盟|和谐四|.四惨案|```合```彩|四民运|合|四天网|四学潮|合彩公司|合彩白小姐曾道人特码|肆|合平台出租|合彩特码论坛|合彩曾道人白小姐|星合彩|合彩美女图库|-四|合彩白小组特码|星合彩公司|?四|.四|合彩网|-合-彩|.四事件|合彩开奖时间|合彩特码开奖|合彩资料图库|四民運|河蟹四|码|合彩网上开户|合采白小姐曾道人特码|合採|四运动|合彩券|氟化铀|一零|月聯盟|四式手qq|四|和采|四真相|四運動|合同彩开奖|合彩|合菜|四学运|八插穴色网|合采|合彩免费图库|合彩特码
起|義|义
日|本成人动漫|军|王|本无码3p|韩无码|本av色片|本激情片电影|本av女优|內瓦金融|朱骏|本女优大集合|本无码|本素人|你祖宗|本性爱爽片|本色情小游戏大全|野美沙|蛋|你老母|了狗|本ring|本灌腸|gm|你娘|本av女優|死你|你媽|朱駿|烂|领馆|九城|本援助小姐qq|本成人激情三级片|本无修正|韩色情片迅雷下载|韩bt|逼|本狗|啊|你爸|本无码系列|本武士刀qq|本骚货|本妹|你妈啦逼|本武士刀批发|本gv资源下载|韩艳情片迅雷下载|本av激情片|本3级大片黄色网站|本灌肠|本有码|他娘|本情色|韩有码|本帝国|穿|韩成人爽片|本军刀专卖|日av|本色情动漫迅雷下载|本h色|本帝國|本万岁|本鬼子|你奶奶|本无码dvd|你爺爺|日|本无码bt下载|本情色片|本成人漫画|本有碼|本无码bt|本h画漫bt下载|本无码迅雷|本无码系列合集|本av色情下载|屄|货|本騷貨|你全家|你爷爷|本激情片小说|你|本熟母|他|内瓦金融|x妈|本援交|軍|你妈|你九城|日日|本无码动漫
捏|弄|你鶏巴|你鸡巴|你奶子
歹|徒
姬|胜德|勝德
納|粹
郑|宝清|丽文|余镇|运鹏|义|源|存柱|少东
拦|截干扰器价格
萧|府之败
台|独万岁|湾民国|湾国|wan|獨分子|湾秃鹰qq|湾岛国|湾共产党|湾獨立|獨|聯|湾版假人民币出售|湾秃鹰图纸|湾秃鹰出货|湾秃鹰|湾狗|湾团结联盟|獨萬歲|湾独立|湾独|海危机|海统一|湾党|完|毒|百度湾|湾共和国|办|灣18成人網|湾秃鹰出售|商|海局势|独党纲|湾版假币|弯|湾青年独立联盟|湾最新版假人民币|湾版假币qq|独分子|海大战|海战争|湾自由联盟|湾秃鹰到货|湾政府|语|湾分裂|湾秃鹰订购|独党|人制台|海问题|湾政论区|灣国|湾最新版假币|北故宫|独|盟|湾猪|灣國|湾辣妹免费裸聊|湾秃鹰制造|联|军|湾建国运动组织|du|湾间谍|湾帝国|湾秃鹰电话|湾版假人民币出售qq
吸|血鬼|血兽|毒|精少女|血獸|儲|精|收的圖騰|储
翘|臀嫩穴|臀嫩逼
扑|克分析仪
冚|家产
南|华早报|蛮|街村|联盟|蛮子|海仲裁|大自由論壇|蠻子|京军区|大自由论坛|蠻|華早報
智|能卡|能sim
受|虐狂
掠|夺
莎|士比亚
寫|真
游|行|蕩的僵尸|蕩爪牙|錫坤|xing|戏指引员|戏管理员|蕩的士兵|戲管理員|戏发奖员|戏宫理员
终|结者
动|漫色图|乱|态网|漫a片
轴|永康
应|召|召女郎|招妓女
陳|良宇|水扁|小同|雲|景俊|菊|破空|宣良|學聖|至立|定南|蒙|總統|毅|獨秀|炳基|博志|建銘|軍|唐山|希同|一諮
粪|便
摩|洛客|門教|洛客成人网址|门教
许|愿|财利|信良|其亮|家屯
致|幻剂|信胡温
纠|察员
龟|孙子|投|公|头|儿子
俏|臀摄魄|臀攝魄
丰|满坚挺|乳肥臀|韵少妇|唇艳姬|乳|乳美臀
择|民
网|络电视棒专卖|络评论员|络赌博机|上老虎机|上真人娱乐场|上真钱赌博|上真人百家乐|络usb电视棒出售|络公关删帖公司qq|民党|评员|络封锁|上真人现金游戏|上真钱骰宝|上赌场|络usb电视棒手机|上赌钱|特|络博彩|站负面信息删除|络删帖公司|管|上赌博机|络情色小说|络删帖|络电视棒qq|络电视棒|络危机删帖公司|络活动颠覆|络电视棒供应|络老虎机qq|络真人赌博|络投注|上办证公司|络删帖qq|络管理员|购汽枪|上真钱娱乐场|络公关删贴|上赌博游戏|络负面删除服务|络推广删帖|上刻章办证电话|上诚信办证|管办|络公关删帖公司|络赌场|易sb|络赌博机qq|络电视棒出售
仙|灵签
枪|决女犯|械出售|械专卖店|支|手|决现场|支零部件出售|支弹药购买|支出售|支弹药|支销售qq|专卖|网专卖|货到付款|模专卖网|支销售|支买卖|淫少妇|杀
幹|比|一家|gy|人也|的爽|你|妳|78|逼|bi|女也|炮|你老母|七八|幹幹|你老比|死|你媽逼|她|死你|７８|的你|你娘|全家|他|拎娘|穴|gｙ|砲
弓|努专卖|驽货到付款|弩买卖网|弩制作|弩专卖网|弩专营|弩专卖店|弩麻醉针|弩的制作方法|弩专卖|弩制作方法|弩批发|弩有限公司|弩直销|弩专卖店网|单|虽女干|弩出售|弩狩猎网|弩狩猎专卖|弩商城专卖|雖
薛|偉|伟
垃|圾游戏|圾
瘪|三
移|动电话
抗|日|日老兵
朴|槿惠
裹|本
僵|贼|贼民|賊|賊民|尸
蛋|疼|白同化制剂
謀|殺
俊|龙百美缘下载
撒|切尔|尿|泡尿
肘|永康
5|4狗qq|4式64式配货|4手qiang子弹电话|4式电话|4式手槍专卖|4手qiang子彈提供qq|4手枪价格|4式64式专卖|2ppsa.cn|4式出售|4手槍子彈出售|4手qiang子彈出售|4手qiang子弹提供|4手槍销售|5mm狗粮|4手qiang子弹供应qq|4手槍专卖|4式现货|4手qiang子彈訂購|4手枪子彈供应|4手枪子弹提供|m5m5m.com|4式|4枪货到付款|4手枪子弹出售|4式到货|4hero.com|4手狗买卖|4手狗子弹提供|4猎枪買賣銷售|4手槍出售|4手qiang子弹提供qq|4手槍子彈供應qq|4式转售|4手qiang子彈提供|4手槍子彈銷售|67567aa.cn|4式图纸|4手qiang子弹供应|5sss偷拍区|2sxhy.cn|4式枪支出售|4手狗子彈提供|4手狗|4手狗子弹供应|4手qiang子彈電話|4式64式图纸|4手枪专卖|4手枪子彈供應|4式64式制造|月35|4手槍子彈提供qq|4手qiang价格|4手槍子彈长期銷售|4手枪狗粮出售|4式64式电话|4式qq|8.253.67.74|1hdw.com|6軍刺专卖|4式专卖|4式64式预订|4手枪狗粮提供|4手槍子彈供應|4手qiang子弹销售|4式出货|4式送狗粮|4式64式转售|4手狗子彈出售|4手qiang子彈銷售|4式枪专卖|4式预订|6軍刺供应|4手枪qq|4式64式到货|4式64式qq|4手枪出售|1jiafen.cn|4手狗子弹出售|4手槍子彈长期提供|4手槍買賣|5mm铅弹出售|4式64式出货|4手枪子弹销售|4式手槍买卖|4式制造|1juezhan.com|4式64式现货|4手狗子彈供應|4手枪狗粮销售|4式连锁|4手枪狗粮供应|4手qiang子弹出售|4气狗qq|4式手槍出售|4手狗子彈銷售|4手狗子弹销售|97ft.com|d6d.com|4手qiang子彈供應qq|4手qiang子弹订购|4手枪子弹提供qq|毛党|4手槍子彈提供|4手槍子彈专卖|5sss偷拍區|4手枪子弹供应qq|4式配货|4手槍子彈长期供应|4手枪出让|4式64式订购|4手枪子弹供应|4手枪销售|4手槍子彈電話qq|4式64式售出|4手槍買賣銷售|4手qiang子彈供應|4式64式手枪|4手枪子弹电话qq|4手槍售出|4式订购
惠|澤社群
弩|的制作方法|机制作图纸|机的制作方法|的最简制作方法|用麻醉箭|的图纸|机图纸|的制作方法和图纸|的制作图纸
幼|圖|女|齒|龍|穴|齿|男|童出售|b|香阁|交|妓|幼极品|幼电影|幼同志|女无码|逼|幼|香閣|童买卖
鴿|派
钓|鱼台|鱼岛
賭|博|球|馬
艾|司唑仑|森豪|森豪威尔|滋|滋病|麗絲
就|去诱惑|去色色|去日|业歧视|去誘惑
三|箭气枪到货|唑綸出售|箭牌汽枪制造|k黨|个代婊|唑侖到货|客优|唑侖qq|唑侖合成|级片|級片|浦爱佳|陪女|级激情片|级片种子|棱軍刺专卖|箭气枪制造图|个代表|箭牌汽枪出货|利达直销|级|硝基甲苯|箭氣槍銷售|箭气枪qq|公|码|級|箭气枪订购|民主义|k党|去|唑侖出货|唑仑片价格|個代表|书|唑|利达地址|唑侖送货上门|利达弓弩军刀|去車侖工力|去车仑|驾马车|箭牌汽枪到货|棱军刺批发|股势力|唑侖订购|箭牌汽枪图纸|利达弓弩专卖网|八淫|陪|浦愛佳|宫六院七十二妃|箭牌汽枪电话|利达弓弩直营|刃木折刀|唑仑|挫崙qq|箭气枪电话|唑仑qq|利达弩商店|健弓弩网|棱刺刀折刀|p|位一体|区革命|个呆婊|唑侖配方|箭牌汽枪qq|唑侖销售|箭氣狗出售|箭牌汽枪订购|利达官网|班仆人派|退|秒倒|唑仑专卖店
泄|题|密
征|集业主意见
手|机窃听软件x卧底|qiang貨到付款|机卧底软件破解版|抢到货|qiang子彈訂購|机改号器|機碟中諜軟件|机窃听器软件|槍子彈銷售|qiang货到付款|机卧底监听器|机变号平台|qiang销售|机卧底官网|機x臥底最新版|qiang子彈出售|qiang子弹电话|機x臥底改良版|槍子彈訂購qq|槍价格|抢专卖|机监听器软件下载|qiang子彈供應|qiang子弹供应|狗专销|qiang子弹供应qq|qiang价格|抢出售|qiang子彈供應qq|枪子弹供应qq|枪批发|槍qq|機號碼任意顯示|機x臥底破解版|机x卧底最新版|枪子弹电话qq|槍子彈出售|狗出售|机改号qq|机号码任意显示|枪子弹提供qq|機竊聽軟件|机x卧底专业版|qiang子彈提供|榴弹|槍子彈電話|机窃听器专卖|机铃声下载|机卧底软件下载|机变号软件qq|槍出售|枪子弹出售|狗销售|机监听软件|把手教你做原子弹|qiang子弹销售|机监听器软件|qiang子彈提供qq|把手教你做炸彈|机窃听器购买|qiang子彈銷售|机改号软件下载|机变号器|槍买卖|枪|机改号软件qq|qiang子弹提供qq|机窃听软件下载|把手教你制作大威力炸弹|机变号软件|把手教你作原子弹|机号码修改软件|机x卧底增强版|机x卧底免费版|槍子彈提供qq|qiang子弹出售|枪买卖|机变号器qq|段极为老辣|机改号机|槍买卖手槍|机改号软件|淫|工獵刀专卖|槍子彈提供|弩制作|机碟中谍软件|枪子弹供应|枪qq|机卧底软件专卖|枪子弹提供|把手制作原子弹|铐出售qq|机x卧底破解版|工刀奴专卖|机卡复制器|机卡监听器价格|机窃听软件出售|qiang子弹订购|槍子彈供應|槍子彈供應qq|狗|机x卧底软件|机变号机|机偷听器软件|槍销售|機監聽軟件|qiang子弹提供|枪子弹销售|机窃听器公司|机x卧底免费试用|机窃听软件免费下载|机窃听软件破解版|工猎刀专卖qq|qiang銷售|机x卧底|机x卧底监听器软件|弩图纸|枪式折叠三用弩|机007间谍软件|机号码任意显示平台|机x卧底改良版|机改号器qq|铐货到付款|机窃听软件|狗专卖|机监听器
龐|建國
死|全家|gd|gm|蠢|逼
费|良勇|鸿泰
里|菲斯|根|鹏|藏春|昂
則|民
銀|行卡復制器|民吧
直|男打枪|刀匕首直销网
招|妓|鶏|鸡
免|费视讯裸聊网|費淫姦黃色電影|費偷窺網|費成人網站|费一夜情裸聊|费激情视频|费成人影片|费成人聊天室|費艷情淫穢小說|费成人电影|费偷窥网|费a片|房费名模女儿|費a片|费激情裸聊网|费看a片|费成人网站|费a片下载|费成人图片|费裸舞视频聊天室
淩|鋒|辱
爭|鳴論壇
七|碌|头|連發獵槍出售|連發獵狗出售|连发猎枪专卖|贤帮|大军区|月四日中山公园
隱|者之路|窩窩
恥|辱輪奸
药|水
号|码任意显示qq|码任意显|码随意显示|码任意显示
突|厥斯坦|厥革命|破网络封锁|尼斯
應|召
设|局|定任意号码
殉|道圣人
苹|果日报
肾|臟价格qq|脏专卖qq|脏供应|脏中介|买卖qq|源中介|源公司|源价格|源出售|源价格qq|源中介qq|源中介公司|源供应qq|源出售qq|脏出售qq|臟中介|源供应|源提供|脏价格qq|源肝源中介|源中介网|源网|中介|源天下网|源电话|源提供中介
发|漂|票|论功|@仑|~~纶|短信任意显示号码|论工|@沦|~~仑|~轮|~~沦|嘌|抡|正念|伦功|$仑|~~抡|~~轮|票买卖|骚|$抡|$纶|$轮|^^沦|^纶|缥|票代售|@@沦|@抡|@纶|^沦|^轮|~伦|$伦|@@论|^抡|^论|~论|票保真代开|$$抡|$$纶|$沦|@@抡|~纶|票代办|纶|$论|~抡|^^论|仑|囵|愣|沦|论公|$$论|票qq|票保真|源地|生关系|$$沦|@@轮|^^纶|~仑|论|生暴动|$$仑|$$伦|@@纶|^^伦|~~论|奖|票代理|抡功|@@仑|@@伦|^^轮|~沦|浪|轮|国难财|^仑|^伦|票顾问有限公司|伦|财诗|@轮|@论|^^仑|漂代开qq|情|$$轮|@伦|^^抡|~~伦|姣
想|上你|做爱综合网
狩|猎弩货到付款|猎用弩|猎弓弩专卖
杜|正胜|鲁门|冷丁|世成|导斌|德印|智富|魯門
猥|琐|褻|瑣|亵
圖|書管理員卡特
搖|頭丸订购|頭丸销售|頭糖配方|頭丸|頭丸配方|頭丸送货上门|頭丸出货|頭糖出货|頭糖到货|頭糖销售|頭玩|頭糖订购|頭丸到货|頭糖送货上门
劣|等民族
及|川奈央
朱|瑟里诺|德|溶剂|嘉明|容鸡|镕鸡|骏|狨基|容基|立倫|基|榮機|鎔基|总理|凤芝|镕基|熔基|溶劑|立伦|琳|云来|海仑|駿|鳳芝|毛
絕|望之地
乙|醚|肝战友|肝检测|肝维权|醚出货|肝歧视|肝ngo工作者|醚配方|醚送货上门|肝筛选|醚销售|肝携带者|醚订购|醚到货
伯|莱塔销售
低|扣
銷|售立式双管猎枪|售qi狗|售電擊麻醉槍|售手榴弹|售工字牌氣槍|售fx气皇|售水晶冰毒|售自制式64式|售双管平式枪|售m92f式手槍|售虎頭獵槍|售64手枪子弹|售黃牙簽|售仿真气枪|售64式|售钢珠狗|售秃鹰汽枪|售猎狗|售純古冰毒|售手槍子彈|售英国骚本气枪|售左轮手枪|售獵槍子彈|售干擾器|售售用麻醉槍|售步qiang子弹|售92手枪|售健衛小口徑|售美国秃鹰|售92式手槍|售散弹狗|售92手qiang子彈|售工字牌汽枪|售鉛彈氣槍|售防身武器|售92手qiang|售64手qiang|售防身麻醉枪|售獵槍手槍|售77猎槍|售北朝鮮冰毒|售遙控解碼器|售中控解碼器|售健卫小口径|售手槍|售气枪|售蝴蝶甩刀|售自製手狗|售海豹m9|售瓦斯手狗|售散弹槍|售冰古毒|售步槍子彈|售64手槍子彈|售钢珠猎狗|售港38式左轮|售仿真槍模|售64手槍|售港38式左轮枪|售仿真枪模|售獵狗|魂洞|售cfx气枪|售64手qiang子弹|售獵qiang|售92手qiang子弹|售铅弹气枪|售台湾秃鹰|售麻醉枪|售步槍|售广州三箭|售麻古果子|售手qiang子彈|售92手槍子彈|售左轮钢珠狗|售92手枪子弹|售自用电狗|售獵槍|售手qiang|售麻黃素|售麻醉qiang|售獵qiang子彈|售高压狗|售高压气枪|售广州三箭气枪|售袖珍手枪|售仿真狙击枪|售德国a1000|售禿鷹汽槍|售金钟气枪|售子弹|售64式手枪|售54手槍子彈|售娥眉气枪|售高壓氣槍|售64手枪|售步qiang子彈|售盐酸羟亚胺|售步qiang|售俄罗斯654k|售虎头猎枪|售出售双管猎枪|售獵槍麻醉槍|售64式手槍|售64手qiang子彈|售广州三箭气|售猎枪|售手狗|售虎头双管|售工字牌汽槍|售黃綠牙籤毒|售假人民幣|售警棍|售单管猎枪|售散弹枪|售77猎枪|售间苯三酚|售45mm狗粮|售92式|售92手槍|售54手qiang子彈|售k粉|售仿真来复枪|售司马系列气狗|售ffx氣槍|售92式手枪
咳|药水
诺|姆|世纪|查丹玛斯
意|志不堅的圖騰|淫
柳|斌杰|树中学
體|育總局|奸
鸟|你|gm
范|长龙
北|高联|京之春|京军区|京政权|京风波|京當局|美自由論壇|島優|美自由论坛|大三角地论坛|朝鲜|韓|京帮|京xx網|大三角地論壇|妹|韩|京当局|京xx网|姑|\*京
親|美|民黨|日
灵|灵教|仙真佛宗|码|动卡
前|苏联|凸后翘|凸後翹|阴后庭抽插自慰器
京|暴|爆
促|性腺激素
打|倒中共|倒共铲党|工者俱乐部|你丫挺的|炮|飛機|手枪|砸抢|倒共產黨|手电话|倒共产党|飞机|倒共党|倒中国|倒中国共产党|野炮|i
插|入内射|你娘|穴图|女|入穴|b|進|进来|你老母|肛|你爸|爆|弄|你媽|阴|阴茎|那嗎b|那嗎比|穴止癢|你爷爷|进你下面|进穴|我|妳|陰莖|进|比|那吗逼|妹妹电影|你|那吗b|你全家|你祖宗|的好舒服|他|暴|后庭|gm|那吗比|穴手淫|那嗎逼|後庭|深些|穴|插|妹妹|陰|你妈|她|肉|你爺爺|入內射|你奶奶|逼|穴止痒|bb成人电影
霪|水
孫|大千|中山|文|逸仙
閻|王|明複
鷄|巴
狼|族娱乐网|客黄色网|友|客免费成人视频网|友论坛
莲|花逼
湿|穴|身诱惑|了还说不要|了还说要
同|房|志交友|志用品|性恋上门|居万岁|胞书|城性息|性恋俱乐部|志拉拉服务|城换妻|一教|性恋|修交流正法修炼|城裸聊
仿|真64手枪专卖|真54手枪专卖|真槍模出售|真人皮货到付款|真气槍销售|真枪到货|真气枪出货|真槍专卖|真qiang到货|真枪模制造图|真槍销售|真气枪到货|真气枪订购|真假钞|真人皮面具专卖|64|真面具qq|真面皮货到付款|真槍到货|真枪|真来复枪出售|真枪销售|真气枪销售|真气枪专卖店|真狙击枪出售|真脸皮货到付款|真脸皮qq|真面皮qq|真面具货到付款|真qiang专卖|真qiang出售|真气枪出售|真槍出售|54|六四|真槍模专营|真枪模出售|真枪模到货|真枪模电话|真枪模出货|真枪模qq|真气枪制造图纸|真气枪qq|五四|真金属枪专卖|真枪改装|真人皮qq|真枪气枪专卖|真枪买卖|真枪模订购|真气枪电话
形|式主义
莱|特
付|申奇|费许愿|费抽
华|语世界论坛|国锋|盛顿|国|夏文摘|天高科|达通迅|岳时事论坛|建敏|主席|泰通讯|通时事论坛|乔中国革命党
丽|春苑
真|实文凭|钱扎金花|鎗出售|钱斗地主|实自拍|人二十一点|钱梭哈|相|人美女视频聊天室|实偷拍|人视频裸聊|钱游戏|实有效文凭|人娱乐城|人游戏百家乐|人在线裸聊|人裸聊服务|空失身|人视频裸聊网|人裸聊视频|实文凭qq|钱百家乐|念|木加美|人裸聊|钱买假钱|善忍|人娱乐城qq|实淫妻|正的冰毒卖家|实身份证qq|主|钱龙虎游戏|实身份证买卖|人轮盘|钱下注|人娱乐老虎机|钱棋牌游戏|钱赌博|实2代身份证qq|槍销售|实学历办理|枪专卖|人赌博网站|主党|善忍艺术展|主安拉|人色片|钱博彩网|象|人娱乐老虎机qq|钱网络赌场|钱博彩导航|耶稣教会|理探索者|人激情裸聊|理教|他妈
活|体器官|体实验|体器官移植|動管理員|动管理员|動|佛|人器官
拱|铲
茎|候佳阴|精
登|輝|辉
趕|你娘
投|毒|毒杀人|注取现|票公司|注博彩|公
斐|得勒
骡|干
的|大闹剧|中共秘密情报网|黄陂区委党校痴迷
接|听对方任何来电|听对方所有来电|听对方所有任何电|免费|听免费|受对方所有电话
0|9city.com|07间谍免费试用|07间谍免费版|07间谍增强版|07间谍最新版|8宪|07間諜改良版|07間諜破解版|07间谍改良版|0sm.cn|07間諜最新版|571qq.com|8xz|07間諜專業版|07间谍破解版|07间谍专业版|1gh.com|25game.cn
添|空|逼|你下面|阴
碌|葛
怀|特
延|安日记
与|时俱尽|气狗会友
訂|購步qiang子彈qq|購手qiang子彈qq|購手qiang子彈|購獵qiang子彈|購77手qiang子彈qq|購步槍子彈|購手槍子彈|購步qiang子彈|購獵qiang子彈qq|購54手qiang子彈|購64手qiang子彈|購92手qiang子彈|購64手qiang子彈qq|購92手qiang子彈qq|購64手槍子彈|購92手槍子彈
遗|留问题
翹|臀嫩穴|臀嫩逼
奶|油冰出货|大屄肥|頭|挺臀翹|奶|罩|油冰验货付款|油冰配方|妈|油冰出售|油冰合成|油冰销售|奶的|头真红|油冰送货上门|油冰到货|子|挺臀翘|油冰订购
杨|思敏|周|巍|建利|怀安|月清|洁篪
獨|裁|裁政治|夫|立臺灣會|立臺灣
威|而柔|而钢|胁论
浓|硫酸|的精液
氟|硝安定买卖
碧|香亭|月吟阁自由联盟|月吟阁|莲|池
采|花堂
梁|光烈|擎墩
显|示任意号码|示任意手机号
鬼|畜轮奸|輪姦|子|村|畜輪奸
运|营官|营人|输发票代开|营|营者|营组|营商|营长
测|试|绘局
維|護
二|乙基酰胺发抡|百五|代身份證当面交易|代假身份证|穴中出|逼|二八事件|屄|代假冒身份证|b|代個人身份证|代精仿身份证|代身份证qq
3|p性爱|p炮图|65gn|65tttyx.com|kwow.com|p性愛|.19事件|d肉蒲团下载|d网络电视棒qq|d成人电影|65在线投注|d性爱电影|d网络电视棒手机|07射钉枪改造|号文件|p炮圖|p美女图片|p淫女|d高清成人电视棒|d网络电视棒出售|07射钉枪改装|3bbb走光|7447.cn|p视频|dh卡通|d成人网络电视棒
吹|牛逼|簫|萧|气娃娃|箫|喇叭
混|亂的圖騰|帐政府
宗|功|教极端主义|教
济|世灵文|南军区
山|本五十六|口組|口组|奈钾出售|猪气手枪
于|幼軍|大海|幼军|浩成
锦|涛
视|频裸聊聊天室|频裸聊|频裸聊qq|频偷拍|频做爱推荐|频祼聊
婷|婷色情五月天|婷基地|婷激情聊天室
藏|m|毒|青會|独|民|西|du|婦會|人|獨|字石|暴乱|立|青会|传|青社|妇会
阳|江刀具供应|江刀具销售|江刀具直销|物|痿|精|江刀剑批发|江刀具网|江刀具商城|江刀具批发|江刀铺军刀专卖|具|江市刀具批发网|江刀具军品网|江刀具甩卖|江户外刀具销售|江刀具直销网|江刀具专卖网|江刀具
书|记
櫻|井
軍|用步槍出售|妓|用潛水刀专卖|用匕首专卖|用手槍出售qq|用步槍销售|用手槍销售|用手槍出售
瓦|斯手狗图纸|斯手狗出货|斯手狗出售|斯手狗qq|斯手狗制造|斯手狗电话|斯手狗订购|斯手狗到货
賓|周|館女郎
父|女乱伦
掰|穴皮卡丘|穴打洞|穴
鹿|城娱乐|城娛樂
让|中共下课热心做大法工作人民|你操
冤|案
启|蒙派
安|全局|倍晋三|拉|魂网|装天线节目|南|非他命|眠酮|倍晉三
地|下刊物|下洗钱|下钱庄|塞米松|下先烈们|下的先烈们|动仪|下教會|下教会|下律师服务点|狱召唤|税髮票qq|藏
射|顏|钉枪改装|釘槍改裝|奶|了還說要|钉枪改气|出来|爽|了|了还说要|钉枪改装方法|乳|颜|钉枪改猎枪|精
燕|玲论坛|南评论
步|槍供應|qiang子彈供應qq|槍子彈銷售|qiang出售|qiang哪裡有賣|槍子彈提供qq|qiang子彈訂購qq|qiang子彈訂購|槍子彈供應|qiang子弹出售|槍子弹訂購|槍货到付款|qiang子彈電話|槍子彈供應qq|槍子彈出售|qiang货到付款|枪子弹供应qq|qiang子弹订购|qiang子弹提供|qiang子彈提供|枪子弹供应|qiang銷售|枪专卖|qiang子彈提供qq|枪子弹电话|qiang子彈出售|槍子彈提供|qiang子弹供应|qiang貨到付款|qiang子彈銷售|槍销售|狗专卖|qiang子弹提供qq|qiang子弹供应qq|槍子彈訂購qq|槍出售|qiang子弹电话|枪子弹提供|枪子弹出售|qiang销售|qiang|枪出售|qiang子彈供應|qiang子弹销售|枪子弹销售
暗|黑法師|杀
赠|送话费
薩|達姆|噠姆|馬蘭奇
含|屌|苞少女
闹|独立
以|商养证|文养整政|茎至洞
歡|歡娛樂時空|樂性今宵
透|视|特|码|视眼镜|视软件|视牌九
切|七
胡|总书记|緊掏|派|春华|惊涛|boss|耀邦|喬木|j涛|海峰|温政体|紧涛|的接班人|曾合作|曾联手|系人马|錦淘|景涛|錦濤|紧套|椒基甲酮订购|主席|瘟|王八|jintao|椒基甲酮送货上门|系|书记|海清|温|紧掏|锦淘|x|平|公子|景濤|總書記|椒基甲酮出货|锦涛|温政治|温接班人|温新政|温暴政|锦滔|xx|椒基甲酮配方|温核心|曾江恶斗|哥|江|jt|椒基甲酮到货|錦滔|总|乔木|志明|总书记，胡景涛|锦涛接班人
干|比|你老比|你|gy|七八|gm|妳娘|妳|你妈b|扰器出售qq|逼|全家|女也|７８|死你|的爽|妳妈|柴烈火|你妈逼|干干|妳老母|gｙ|穴|你妈|你娘|你全家|她|78|死|的你|拎娘|bi|一家|他|人也
錯|b|逼|比|那嗎b|那嗎逼|那嗎比
彩|信改号软件|票机|票|铃费|民提供|票预测|信改号|信号码任意显示
恩|格斯
脱|内裤|光|衣舞|衣表演|衣激情聊天
如|來|何改装射钉枪|来|何做炸药炸弹|何制作原子弹
被|幹|人干|插|操|迫|立教|立|干|立王|虐|逼
連|勝德|勝文|戰|發|続失禁|方瑀|惠心
铅|弹气枪订购|弹气枪电话|弹气枪销售|弹气枪出售|弹气枪制造图|弹气枪qq|弹气枪到货|弹气枪出货
曼|德拉
簡|肇棟|易炸蛋製作方法
倪|育賢|育贤
(|港)内部
花|樣性交|和尚社区成人性用品|和尚社区|和尚北美社区最新地址|和尚导航|样性交|柳|和尚最新地址|花公子
诚|办2代身份证|信办假证qq|信办证刻章公司|信汽狗专卖|信专业办证|信办证咨询|信办证电话|信制卡|信办理文凭|信办证集团|办一代身份证|信代开发票|信办证刻章集团|信高效办理假证件|信代办|信办证集团qq|信假身份证|信办证qq
律|师证办理
软|件式监听器出售
脚|交
武|腾兰|藤兰|藤蘭|装反抗|士刀专卖|藤|警
個|人崇拜|人資料
专|业代考|售氯胺酮|卖军品刀具qq|业代理开发票|卖特种部队专用弓弩|业帮人清债|卖双管猎枪|售咖啡因|卖气狗|业復仇|业定制易容面皮|业帮人讨债|业幫人追債|业办证|卖气狗qq|卖54式64式|业代人出气|业办证公司|卖麻黄素qq|卖钢珠弓弩|业定制易容人皮|业定制高仿真脸皮|业雇人復仇|门销售各种手弩|卖各类防身器材|业办证书|业定制仿真人皮|卖开山刀qq|业替人杀人|业找職業殺手|卖54式qiang|业警棍出售qq|销高仿人皮面具qq|业证件网|业提供开锁工具|业办假証|制政权|业帮人复仇|业定制乳胶脸皮|业替人处理恩怨|业代人报仇|业替人绑架|卖开锁翻转枪qq|卖赵氏钢珠弓弩|卖77式手枪|业定制美化面皮|业幫人勒索|业找人报仇|制|卖兄弟连弓弩|卖m4弓弩视频|卖军用弩|业幫人消災|业帮人处理恩怨|业帮人追债|业帮人勒索|业提供杀手|业定制高仿真面皮|业定制硅胶脸皮|业解决情敌|业替人毁容|业制造意外消失|业替人了仇|销高仿人皮面具|业替人消災|卖肝源qq|卖军用狙击弩|业定制仿真面皮|业帮人敲诈|业替人敲诈|业代人報復|卖销售弓弩|卖弓弩狩猎网|卖狩猎弩|业开锁qq|业消除负面消息|业复制克隆银行卡|卖折叠阻击弓弩|业地下警队|业替人勒索|业找人復仇|卖军刀qq|业帮人處理恩怨|卖77式qiang|业负面信息处理|业网络证件办理|销人皮面具|业帮人了仇|业办理假身份证|业專業打手公司|业证件办理中心|业替人出气|卖猎刀|业复制银行卡|业删贴服务|卖战神弩|业定制进口硅胶面具|业定制高仿面具|业替人复仇|业替人出氣|卖64式手槍|业销售气枪|业制作高仿硅胶面具|业毀容|业退伍兵杀手|业帮人打架|业找人報仇|业幫人被欺負|卖驽弓|业幫人砍人|卖小口径步枪手枪|业帮人打架报仇|业定制乳胶面皮|业定制硅胶人皮|业退伍兵打手|业办证ｑｑ|业雇人報仇|卖气枪|卖三利达手弓弩|业警棍出售|业替人復仇|业提供国内外女郎|业替人討債|卖64式qiang|业出售冰毒|卖鹰枪货源|业替人打架|业制作人皮面具|买腎源qq|业解决小三|卖小口径步qiang|业删帖服务|卖防身电警棍|卖力斯曼弩|业定制随机面具|业定制仿真面具|业帮人杀人|卖上海工字气枪|卖秦氏弩|业特种兵杀手|业提供打手|卖单管猎枪|业找人辦事|卖各类防身电棍|卖警用手铐qq|业定制美化脸皮|业替人敲詐|业幫人處理恩怨|业帮人毁容|业帮人砍人|业代理投票|卖92式qiang|业开锁工具出售qq|业删除负面信息|业替人打架报仇|买肾脏qq|业找人办事毁容|业替人追债|业打手公司|业投票服务|卖出售弓弩|业幫人清债|业幫人報復|门批发秦氏弓弩|栏毒害世人|卖力斯曼弓弩|业替人制造意外死亡|业帮人绑架|售可卡因|业删帖qq|卖汽狗|业办理毕业证|卖弹弓弩|业定制硅胶面皮|业替人殺人|业复仇|业幫人打架|业办理各种证件|业定制高仿真人皮|业帮人打架报仇qq|卖各类警用装备|业定制硅胶面具|业勒索|卖槍|业定制人皮面具|业代人报复|业替人報仇|卖小口径手枪步枪|卖防身电棍|业雇人报仇|业办证qq|业制作高仿人皮面具|卖美国进口军用弓弩|卖大黑鹰弓弩|卖户外狩猎弩|业定制明星人皮|业制造意外死亡|业帮人被欺负|业幫人了仇|卖重型两用弓弩|卖全金属狩猎弓弩|卖猎豹弩|业幫人殺人|卖高仿真人皮面具|卖小口径手枪|卖小口径步枪|业消除负面信息|用发票代开|业特种兵打手|卖军刀|业网络删帖|卖高压电击棒|卖肝脏qq|卖森林之狼弓弩|业復仇了仇|业幫人討債|卖92式手槍|营气狗|业高仿真人面具|业复仇公司|业幫人出氣|买肝臟qq|卖侦察兵折叠弓弩|卖狩猎弓弩|业定制进口硅胶人皮|业代人報仇|业代人制造意外死亡|业删帖|业幫人敲詐|卖开山刀|卖各类防身电警棍|卖猎枪|业定制进口硅胶面皮|业定制高仿面皮|业定制高仿真面具|业解決情敵|业替人消灾|业替人报复|业替人追債|卖腎源qq|业专业打手公司|业雇人复仇|业帮人报复|业警官证制作|卖肾脏qq|业替人清債|业网上刷票|业开发票|业证件代理|卖兰州弓弩网|业定制进口硅胶脸皮|业定制易容脸皮|业幫人綁架|业提供工字牌|卖77式手槍|业开锁工具出售|业制作文凭|卖军用狙击弓弩|业帮人消灾|业报仇|业删帖机构|业找杀手|业制作新版警官证|卖麻醉弓弩箭|卖弓弩之家|卖猎枪霰弹|业替人毀容|业替人清债|业替人砍人|业退伍兵殺手|业代开发票|业开增值税发票|卖电击器电棍网|业替人綁架|业地下警隊|业地下保安队|业代办驾驶证|卖小口径手qiang|卖军品刀具|业帮人制造意外死亡|业经销假钞|业定制人造脸皮|业定制随机人皮|业制造特殊死亡|业帮人出气|业职业复仇|业職業復仇|卖54式手槍|卖赵氏钢珠弩|业找人复仇|业代人了仇|业替人报仇|业找职业杀手|业替人讨债|业找殺手|卖肾源qq|业幫人杀人|业定制高仿脸皮|业替人處理恩怨|业复仇了仇|业找人辦事毀容|业代人出氣|业定制乳胶人皮|业定制仿真脸皮|业定制易容面具|业定制乳胶面具|业定制弹簧人皮|业幫人毀容|卖上海工字牌气枪|业办理警察证|买肝源qq|卖户外狩猎弓弩|业特種兵打手|业刷票服务|卖防身电警棍网|卖钢珠弩|业定制人造面皮|业幫人清債|业雇人打架|业找打手|卖手机窃听软件|卖五四式手枪|卖进口气槍|政|业代理开票|卖三利达弓弩|业定制高仿人皮|业特種兵殺手|业幫人制造意外死亡|卖折叠手弓弩|业地下保安隊|业替人報復
杂|种
雞|奸|巴|８|八|吧|叭|掰|芭|巴暴脹|雞|毛信文匯|ｙ|y
妖|媚熟母|怪|野|你
錦|濤
阉|割|狗
赚|钱秘技
元|老蘭提(沃德）
葬|独
乡|巴佬|村如此多娇
窩|窩客
田|弘茂|紀雲|纪云
各|种文凭|种证书|地凤楼|种证件代办|行银行卡出售|类银行卡出售|界众生|种证件|类警用装备出售|类军用枪出售|种枪支出售
侨|办
尖|阁列岛|阁|阁群岛
供|应车主名录|应64手枪|应小口径步枪|應自用电狗|應手槍子彈qq|应小口径步槍|应54手枪子弹|應虎頭獵槍|應健卫14步枪|應54手qiang子彈qq|应步枪qq|應92手槍子彈qq|应三氯化砷|應64式手槍|应仿真枪模|应麦角醇|应高仿人皮面具qq|應92式|应硝酸铊|应仿cz75bd手枪|應仿真槍模|應手槍子彈|应92式|應英国骚本气枪|应青蒿素|應獵槍子彈|应金钟气枪|铲裆|应氰化钠qq|应港38式左轮枪|应64手槍子彈|应成人电视棒|应半圆刮刀|应四氢吡喃酮|应冰毒|应92式手枪|应高压气枪|应白黄牙签qq|應健卫小口径|应甲基可可碱|应长治筋|应工字牌汽枪|應ffx氣槍|應92手qiang|应猎qiang子弹|应三箭气枪|應禿鷹汽槍|应64手qiang子弹|应单管猎枪|應獵槍手槍|應64手qiang子彈|应赵氏弓驽|应k粉qq|應袖珍手枪|应眼镜蛇弓努|应肝臟|应健卫步枪|应军用弩折叠弩|铲谠|应氰化钾|应英国骚本气枪|應自制式64式|应银行客户资料|应肾源|应64手qiang子弹qq|应麻古|應步qiang子彈|应雷管qq|应64手qiang|应胡椒醛|应大麻qq|应獵槍麻醉槍|应搖頭糖|应左旋麻黄素|應金钟气枪|应usb全球网络电视棒|应氢化可的松|应最新92位码汽车解码器|应步枪子弹|应迷你网络电视棒|应肝脏|应网络usb电视棒|應麥角酸|应仿真狙击枪|應麻醉qiang|應92式手槍|應工字牌氣槍|應麻醉枪|应三唑侖|应秃鹰汽枪|應步槍子彈qq|应白牙簽|应鉆石冰|应鹽酸羥亞胺|應虎头猎枪|應獵槍|应猎枪子弹qq|应手枪子弹qq|应大冰砖|应自用电狗|应64式手枪|应白牙签|应仿真枪|应个人商务数据资料qq|应一手老人数据|应2011高考名单|应肝源qq|应獵qiang子彈|應美国秃鹰|应左旋麻黃素|应老板通讯录|应92式手槍|應高压狗|应警用防身电击器|應qi狗|应个人商务数据资料|应冰钻|应银行客户资料qq|应袖珍手枪|应法人通讯录qq|應苯三酚|应黄体酮|应最新汽车解码器|应麻古qq|应黎城面|應广州三箭气枪|應仿真狙击枪|应步qiang|應m92f式手槍|應64式|应54手qiang子弹qq|應77手槍子彈qq|应溫切斯特|应麥角酸|应间苯三酚|应防身警用电击棒|应娥眉气枪|應港38式左轮枪|應手槍|应肾源qq|应步槍|应小冰磚|应广州三箭|应獵槍|應工字牌汽槍|应摇头糖|应54手qiang子弹|应钻石冰糖qq|應手qiang子彈qq|應54手狗子彈|应植物冰|應假人民幣qq|應健衛小口徑|應獵qiang子彈qq|应高清usb电视棒|應广州三箭|应企业名录资料|应出售双管猎枪|应步qiang子弹|應獵槍子彈qq|应high粉|应盐酸氯|应银行卡|应山猪气枪|應左轮手枪|應77猎槍|應广州三箭气|應娥眉气枪|应汽狗|应人皮面具|应钢珠猎狗|应立式双管猎枪|应m92f式手槍|應猎枪|应车主名单qq|应工字牌汽槍|应92手槍子彈|应54式|应法人通讯录|应钢珠枪|应警用防身电击棒|应虎头双管|应网络电视棒|应真实身份证|应猎枪qq|应廣州三箭氣|應廣州三箭氣|應司马系列气狗|應手狗|应大麻|应92手qiang|應步qiang子弹|應出售双管猎枪|應德国a1000|应手枪子弹|应冰毒qq|应仿真来复枪|應防身武器|應秃鹰汽枪|应子弹|應散弹枪|應92式手枪|應77猎枪|应pcz山猪|应64手枪子弹|應92手枪|应军刺军刀|应高档客户资料|应任意显|應虎头双管|應pcp新贵|应刺刀m9|应高档客户资料qq|应掌心雷|应盐羟亚胺|应肾qq|应猎qiang子弹qq|应lqb362|应神仙糖|应杜冷丁|應高压气枪|應cfx气枪|应台湾秃鹰|應獵槍麻醉槍|应世界名刀|应腎源qq|应qi狗|应手槍|应高清网络电视棒|应秦式弓弩|應水晶冰毒|應海豹m9|应64手枪子弹qq|铲党|应车主资源qq|应高仿真人皮面具|应司马系列气狗|應冰毒|应步qiang子弹qq|應54手槍子彈qq|应溫切斯特1000x|应秃鹰|应一元硬币|应自製手狗|应广州三箭气枪|应77猎槍|应k粉|應步qiang|应77手qiang子弹qq|应搖頭丸|应改号软件|应麻醉qiang|应散弹狗|应精品弓弩|应健卫14步枪|應台湾秃鹰|应黄牙签|应弓弩|應仿真来复枪|應92手qiang子彈qq|應64手槍子彈|应车主资料qq|应老板个人资料qq|应纯缅麻古|应手狗|应车主名录qq|应氰化汞|应海洛因|应ffx氣槍|应77手枪子弹qq|应乙醚|应秦氏弓弩|应业主名单|應64手槍|应铅弹气枪|应64式|应cfx气枪|应正品电视棒|應步槍子彈|应虎头猎枪|应防身麻醉枪|应腎源|应冰砖|应法人手机号码|应三棱刮刀|应健卫小口径|應仿cz75bd手枪|应胡椒基甲基|应冰糖|应汽车干扰器|应金融客户资源|应摇头丸|应92手枪子弹|应罂粟壳|应冰毒出售|应猎枪|应化学冰|产|应股民电话资源|应92手qiang子彈|應獵狗|应汽车解码器|应楼盘业主资料|应麻醉枪|应左轮钢珠狗|应美国秃鹰|應54手槍子彈|应化学冰牙签|應左轮钢珠狗|應步qiang子彈qq|应高清网络tv棒|应鉆石|应公司法人资料qq|应电话营销数据qq|应三箭牌汽枪|应仿真槍模|應92手qiang子彈|应代开发票|應92手枪子弹|应天然咖啡因|应电视购物数据|应喵喵药电话|应钢珠狗|應子弹|应业主名单qq|应92手槍|應工字牌汽枪|應瓦斯手狗|应高仿人皮面具|应間苯三酚|应黄冰|應钢珠狗|應高壓氣槍|应54手狗子弹|应进口气枪|应胡椒基甲酮|应麻谷|应钢珠弓弩|应大小冰砖qq|应防身警用电击器|應仿真气枪|应黄麻素|应手枪qq|应固体炸药|应最新台湾版假币|应工字牌氣槍|應步槍|应眼角膜源|應64手qiang子弹|应健衛小口徑|應立式双管猎枪|应肾脏|应毒鼠强|应老板通讯录qq|應钢珠猎狗|應45mm狗粮|應92手qiang子弹|应各式军用枪qq|应92手枪|应64手qiang子彈|应92手枪子弹qq|应54式64式|应狙击钢珠专用弩|应车主资料|应企业名录资料qq|应港38式左轮|应神仙水|应俄罗斯654k|應港38式左轮|应小冰砖|应瓦斯手狗|应假幣|应手qiang子弹qq|应甲卡西酮|应92手qiang子弹|应奶油冰|应上海工字气枪|应股民资源|应气枪弹|应肝臟qq|應64手qiang|應手qiang子彈|应车主名单|應92手槍|应阳江刀具|應散弹槍|应高壓氣槍|应鉛彈氣槍|应64手槍|应散弹槍|应甲基苯丙胺|应自制式64式|应德国a1000|應散弹狗|应大冰磚|应气枪qq|应獵槍手槍|應鉛彈氣槍|應防身麻醉枪|应45mm狗粮|应老板个人资料|应fx气皇|应64式手槍|应电话营销数据|應单管猎枪|應92手槍子彈|应tnt|應m300|應54手qiang子彈|应92手qiang子弹qq|应黃體酮|应盐酸羟亚胺|应赵氏钢珠弩|應k粉|应77猎枪|應双管平式枪|應铅弹气枪|应车主资源|应散弹枪|应白粉|应king粉|應fx气皇|應自製手狗|應俄罗斯654k|应usb电视棒|应汽车拦截器|应公司法人资料|应黎城面电话|應猎狗|应五连猎枪|应禿鷹汽槍|應仿真枪模|应麻黄素|應假人民幣|應64手枪|应肝源|应冰磚|應64手枪子弹|应麦角酸|应猎枪子弹|应双管平式枪|应广州三箭气|应步枪子弹qq|应氯胺酮|應64手槍子彈qq|应黃牙簽|应水果冰|应股民数据|應77手qiang子彈qq|应麻黃素|应白冰|應獵qiang子彈|应楼盘业主资料qq|应北朝鮮冰毒|应虎頭獵槍|應64手qiang子彈qq|应氰化钠|应左轮手枪|应仿真气枪|應64式手枪|应麻果丸子|應手機變號機|应高压狗|应高清3d成人电视棒|应手qiang子弹
興|奮劑
纳|粹
賈|廷安|育台|慶林
將|則民
岳|武
艹|你|死你
乳|暈|波臀浪|此豐滿|腺|首|此丝袜|此丰满|頭|霸|此絲襪|胶脸皮货到付款|fan|此動人|胶脸皮qq|晕|此动人|爆|溝|胶人皮qq|胶人皮货到付款|胶面皮货到付款|房|沟|交|头|罩|胶面具货到付款|射|尻|胶面皮qq|胶面具qq|球
數|據中國
刹|笔
齐|墨|鲁石化|诺|b短裙
圓|滿
*|法*轮*功*|李*洪*志*
茉|莉花革命
嫵|媚挑逗
道|教|具
肏|妹妹|妳|破|入|屄|你|干|我|穴|这|死|她|娘
徒|弟会
粟|戎生
入|联|珠环|耳关|穴一游
歌|功頌德|功颂德
陆|四|肆|士绅|委会
瘸|腿帮|腿幫
求|简易炸弹制作方法|购三唑仑片
连|胜德|弩出售|发猎枪销售|发猎枪专卖|战|続失禁|方瑀|惠心|胜文|环百家乐
u|sb电视棒手机|sb电视棒qq|ltrasurf|l86.com|u1001.com|nusualperson.com|jthe9|sb电视棒出售|nixbox|stibet|rban-rivals|j
贺|龙|国强|过墙|信彤|卫方
猖|妓
章|孝严|孝勇|孝嚴
肝|源中介|源|脏专卖qq|源出售价格qq|臟中介|臟价格qq|臟供应|脏供应|肾源买卖|源出售qq|源价格qq|源供应|源网
升|天
欠|日|操|干|幹
校|鸡|级复员军官
谭|作人
抵|zhi|制变电站
撅|起大白腚
瞒|报
模|特全套包夜|特裸聊
指|點江山論壇|标股|点江山论坛|定号码改号|定号码变号|定姓名银行卡
锋|同志
癡|乳
大|胆少女|史|麻树脂|東亞共榮|奶媽|波波|陆大法弟子|波|波粉b|赢家|陆无码|量出售各种假币|血比|參考|法好|盖帽|陆弟子|东亚共荣|冰磚销售qq|冰砖出售|乱交|波骚妇|史記|冰砖到货|便|紀元新聞網|久保玲|法弟子|乳頭|马士革钢出售|庄|湖帮|蓋帽|陆邪恶|法|奶头|泽惠|冰砖合成|纪元新闻网|奶|史紀|冰砖|冰磚出货|卫教|東亞|衆真人真事|眾色情成人網|专文凭qq|奶骚女|鶏巴|量供应間苯三酚|黑鹰销售|奶美逼|中华论坛|奶妈|家论坛|学骚乱|法学员|血逼|善大忍|逼|j8|陆嫩模写真|馬士革鋼刀专卖|鸡巴|中國論壇|膽少女|礼包|冰磚到货|家論壇|陆当局|sb|史纪|昭寺|雞巴|胆出位|众色情成人网|纪元|学生包夜|量伪币出售|参考|花逼|冰磚配方|冰砖配方|冰砖订购|藏区|*fa弟*子|膽出位|马士革钢刀专卖|比|麻油|众真人真|师|波妹上门|丑风流记全文阅读|史记|预言|量出售植物冰|冰砖出货|黑鹰驽弓专卖|b|紀元|奶騷女|力抽送|选|威力弓弩专卖|中国论坛|冰磚销售|冰磚订购|波騷婦|母牛综合网|层功|澤惠|纪园|冰砖送货上门|烟|冰磚送货上门|黑鹰弓弩专卖|赦国际|法的弟子|紀園|衛教|中華論壇|亂交|血b|中华情色网|麻|乳|众真人真事|技师出台qq
勾|魂少妇|结奸商|魂少婦
鴉|片|片液
瀛|海镇
辽|宁帮
蔡|启芳|英文；|英文|武|崇国|文勝|陆军|正元|文胜|崇國|啓芳|赴朝
义|军|解
翁|虹|金珠
漏|税|逼|乳
麈|柄
次|郎
蚁|力神
侮|辱性语言
假|车牌|发票专卖qq|硬币出售qq|发票电话|发票销售|身份证办理|发票出售|庆淋|钱代理|硬币批发qq|币qq|钱批发|币批发|发票专卖|身份证|发票出售qq|钞出售tel|币销售|钱销售|钱买卖|冒|鈔电话|币出售qq|发票办理|钱出售tel|人民幣qq|钱qq|证|币|户口本|币假钞|证出售|钞交易|比出售|阳具插穴|发票代理|钞货到付款|钱卖买|币出售电话|钞换真钱|文凭|发票|发票qq|鈔出售qq|鈔qq|硬币买卖|币货到付款|钞出售|钞|币朝鲜版代理|硬币批发|陽具插穴|人民幣銷售|身份证出售|发票出售tel|钞销售|驾驶证办理|硬币qq|庆林|钞交换qq|护照办理|钱|恶谎|币买卖|钱出售|钞换钱|币专卖|币销售qq|硬币货到付款|钞电话|钞出售qq|冒一代身份证|壹代身份证|钱出售价格|币联系电话|警官证qq|1元硬币买卖|文凭办理|慶林|证办理|币代理|青林
乱|伦熟女网|交|伦影院|交系列|伦影片|伦熟女|淫|伦|轮|伦电影下载|交视频|伦图区|伦小说
傳|染性病
擊|倒圖騰|傷的圖騰
愤|青
约|炮
熱|比婭|站政論網|那亞
占|领中环|中|中；|中三子
x|l517.com|ya3.cn|卧底破解版|iao77luntan.1249.net.cn|卧底专业版|iao平|izangduli|ucaihou|ilake|民党|卧底软件官网|tl|insheng|yq2sf.com|xx|iao77|卧底官网|卧底官方网|卧底下载|卧底第四代|itele|wodi破解软件|伴侣|x狗|jp|dns.eu|ing伴侣|izang|uyuan|卧底|isheng|藏|卧底软件免费下载|iaoquan|wodi软件版下载|inwenguanzhi|iejiao|uxiangqian|iuau.cn|injiangduli|iao77.1243.net.cn|夜激情|ihanuke|q-wl.cn|uri|wodi软件官方网|卧底增强版|卧底软件下载|ijinping|iaoqinzaixian.cn|i藏|卧底官方网站|到噴屎尿|yxgh.com|uechao|ingqingzhongren.1174.net.cn
彈|簧刀专卖|劾
叼|你媽|你妈|你
龙|吟百美缘下载|华经|卷风|新民|虎豹|虎
刚|比|比样子
呻|吟
全|国手机号码抽奖|国人大|国车主资料|国办证服务|球网络电视棒qq|国人大副委员长|裸|家不得好死|球网络电视棒出售|國兩會|裸野鸳鸯|家死绝|套包夜服务|国号码任意设置|国号码任意显示|钢刀具qq|范围教会|家死光|仓|国两会|能神教|球人文纪元|球网络电视棒手机|套美女|能神|國人大
儿|子
骨|干分子|獅
藤|井彩
猪|哥6合网中国网址联盟|容基|倌|毛|操|聋畸|毛1|聾畸
泡|沫經濟|沫经济
微|型钥匙扣数码相机|型袖珍手狗
私|處|募|处|-服|！服|\\服|人伺服器|￥服|密处|?服|彩|/服|—服|%服|·服|服|人服务器|家侦探|#服
权|斗|柄|重股|贵集团
鲁|迅
绝|食|食宣言|色皇城|色淫妃
海|乐神qq|洛因制作教程|洛因订购|luo因|洛因到货|雲武士刀专卖|洛因合成|洛因配方|洋局|豚沫沫|乐神专卖|乐神|關總署|洛因销售|洛因送货上门|洛因出货|豹m9销售|洛因|关|洛因销售qq|外民运|军突击刀专卖|洛因出售|南私彩|明威|特|乐神专卖电话|豹m9出售|洛因麻古出售
窝|囊中国|窝客
睾|丸
麦|角乙二胺销售|角酸配方|角酸出货|角酸送货上门|角酸到货|司卡林|角酸|克斯|角酸订购
婬|乱军团|亂軍團|水
涉|日|台政局|嫌反动|毒|黄|枪
广|州三箭出售|州三箭气出售|州三箭出货|州三箭到货|闻|西桑拿网|告发票代开|州三箭订购|州军区|场上的血|场上的鲜血|州三箭电话|场上的热血|州三箭气枪出售|州三箭制造图|州三箭qq
緊|縛淩辱|縛|穴
雙|管立式出售|管獵槍出售|管獵槍销售|十節|龍入洞|管平式出售
浮|尸国
助|考|师世间行|理|手威爾特
醉|笑卧乡野全文阅读
戒|严|yan
言|论自由|禁
滕|文生
邓|笑贫|不群|矮子|xp|力群|晓平|朴方|质方|小平访美|小平|榕|颖超日记|小平；江泽民
黄|琦|祸|华华|慈萍|网|牙签送货上门|色网站|色文学|色小说下载|色激情爱图|牙签配方|牙签买卖|片|牙签出货|牙签出售|教|兴国|色小说|色小电影|义交|网情色社区|色图片|色a片|海刺胡|色漫画|色电影免费下载|站|大仙|翔|剑辉|仲生|骚冰供应|麻素出售|麻素供应|牙签到货|色成人网站|小说|菊|色|色影视|大仙六合彩|局|牙签验货付款|色裸聊网|丽满|伯源|色视频聊天|牙签订购|色电影|色激情片|色妹妹a级大片|金圣水|牙签合成
悠|悠成人社区
救|度|度世人|度一切众生|国p2p|囯集中淫
离|长春
媽|白勺|b|比|的|批|個|逼
习|主席|仲勋|太子|明泽|近平|大大|远平
赫|鲁晓夫|蒂彻|魯雪夫
媚|药少年|外|藥少年
換|妻大會|妻雜交
毛|厠洞|賊東|党|贼东|厕洞|猪席|片下载|厕东|太祖|片影院|片在线|泽东|鲍|相|zx|晚年周恩来|片|zd|澤東|xx|都露出|一鲜|鮑|主度|主席|賊|瘸腿帮|泽东复活
码|诗|中特|报
已|撸
燃|烧弹制造|烧弹的制作方|燒彈制作
建|國黨|国党
衬|建铭
腚|眼
重|生之乱世种马yy传奇|组|建帝国
萨|马兰奇|达姆|哈卜
拐|卖|賣
阴|阜|b|囊|dao|纯|缔|道图片|唇被插|门|丘|穴|阜高耸|茎插小穴|蒂|壁|部特写|户|小撕大|核|精|茎增大|di|护|茎|道|唇|部|毛|chun|水|屄|道。
奧|巴馬|馬爾|克拉|拉德|利弗|魯奇|倫|特蘭
赔|率
潜|伏者破解版|伏者免费版|伏者专业版|入潜出|伏者手机监听软件|伏者免费试用|伏者改良版|伏者录音版|伏者增强版
審|查
届|中央政治局委員|中央政治局委员
积|克馆
老|虎机|gｙ|共|逼|味臭化西|板数据qq|毛子|gy|习|姜|胡|人政治|板手机|少乱伦|毛|江|母|虎機|少亂倫|挝国营赌场|j|人集团|b|比|卵
嫩|穴肉缝|缝|鮑魚|逼|屄|女|鲍鱼|b|穴|縫|鲍|奶|鮑|穴肉縫|bb
總|理
倫|功|公|攻
婚|外情调查|介
弟|痛|大物勃|子|疼
默|克尔|罕默德|克爾
a|v小电影|v狼|obama|iort墓地|片迅雷种子|mateur|v伦理片|luoyue|omaer|rqus会议场|v女优影片|dministrator|aad.s.59764.com|片基地|4y|dmin|nal|aac.s.51524.com|级|v视频|4u人体艺术|lafate|nbeijinsan|片|33.com|v两性|片下载|v激情视频|v电影|v出售|v女|片网|nnan|isenhaoweier|片播放器|v伦理电影|sgardcn.com|ss|v女优|ids|ny2000.com|k-47军刀出售|bian|i滋|片在线看|a.yazhousetu.hi.9705.net.cn|v美女小视频|v资源|4u|sshole|tan的移动石|v文檔|bianwansui|v|扁
監|管|禁陵辱|聽無線通話軟件|視塔|視塔哨兵|視塔哨兵隊長|獄|督
她|妈|妈的金日成|媽|媽的
卧|槽|艹
汉|维|风|奸|人
群|陰會|奸輪射|奸|交乱舞|体事件|体灭绝|射|奸亂交|交派对|阴会|交亂舞|交|奸乱交|体灭绝和纳粹式的暴行|发|发器|魔色舞|奸轮射|体性事件|交视频
昆|圖
秃|鹰电话|鹰qq|鹰气枪购买|鹰气枪出售|鹰汽枪到货|鹰订购|鹰出货|鹰汽枪出售|鹰汽枪货到付|鹰制造图|鹰气枪专卖网点|鹰到货|鹰汽枪qq|鹰汽枪电话|鹰汽枪出货|鹰汽枪制造图纸|鹰汽枪销售|鹰汽狗出售|鹰气枪网|鹰汽枪订购|鹰汽狗
掄|功
铁|凝|鹰帮竹林联盟
硝|酸汞供应|酸胺炸药|酸胺炸药出售|铵炸药的配方|化甘油铝热炸药|酸甘油炸药制造|化甘油
倭|国|寇
替|人讨債|人復仇|人打架|人綁架|人复仇|人报复|人清债|人勒索|人消災|人追債|人了仇|人报仇qq|人报仇|人毀容|人处理恩怨|人消灾|人殺人|人跑事|人敲詐|人制造意外死亡|人毁容|人报仇公司|人討債|人出氣|人打架杀人|人讨债|人追债|人敲诈|人杀人|人绑架|人處理恩怨|人報仇|人報復|人报仇电话|人砍人|人出气|人清債
盜|竊犯|撮
匕|首麻醉枪专卖|首麻醉枪出售
曰|你|gm
掌|心雷出售
徐|匡迪|邦秦|國舅|文库|光春|中雄|才厚|明|水良|财利|国舅|国勇|向前|绍史
作|爱|秀|愛
常|勁|受教|劲|委|万全|委汪兆钧
友|情气枪专卖网|好的魯德
栗|智|战书
封|从德|锁消息|面女郎|從德|殺|印的靈魂騎士|圣
湯|光中
宋|xx|美龄|楚瑜|書元|平|书元|平顺|庆龄|祖英
蒙|獨|古達子|古獨立|独|汗药|古达子|古韃子|汗药出售|古鞑子|古分裂分子|汗|族|古独立|古獨|古独|尘药
厕|所盗摄|所偷拍|奴
排|泄
贡|挡
乖|乖粉
髑|屙民
德|維爾|国之声|维尔|國博克軍刀专卖|国博克军刀专卖|版ppk供应
畜|生|牲
天|剑二型飞弹|主教|天情色|剑一型飞弹|安門|安門一代|按门|安门自焚|网电子报|皇|安門事件|要灭中|要灭中共|怒|安门情人|安门母亲运动|天干貼圖|阉|灭中|生我材必有用二|安门事件|天干贴图|安門錄影帶|閹|目|葬|然素人无码|安門屠殺|父的儿女|安门|线宝宝|网人权事务|皇陛下
露|阴照|毛|点|穴|屄|點|b|陰照|逼
能|樣|样
特|么的|码六合彩|码论坛|服生|殊名录|种兵打手|码开奖|朗普|贡|快办|码网|种兵杀手|共|肖|码
寻|肝源|找夜夜情|甸冰毒
觀|世音
明|星情爱|星人皮货到付款|慧网|星淫图|思网|慧周报|慧網|星淫圖|慧|心网|hui|慧专讯
核|工业基地|武器|潜艇|蛋|潛艇|工業基地|武器制作方法
袁|依凡|纯清|鹰
操|gy|你全家|妻|穴喷水|gm|你奶奶|那吗比|人也|七八|死|那嗎b|那嗎逼|狗|她|那吗逼|你爸|小逼|我|你爺爺|你八辈祖宗|爛|尼妈|爽|那嗎比|你大爷|你媽屄|吃大便|行|黑|女也|７８|你妈|肿|射|屄自慰器|穴噴水|蛋|母狗|你媽|你祖宗|女人穴|腫|78|xx|你娘|死你|他妈|你|烂|王|比|b|b指南|屄|逼毛|鸡|你爷爷|屄淫图|妳|他|逼|穴|鶏|你妈屄|gｙ|那吗b
毀|滅射手|滅步兵|滅騎士
圆|满|顿|明网
抠|穴|你妈|b|逼
何|清涟|候华|勇|山|德普
探|测狗
商|品销售发票|务部|丘单车网
批|发供应小冰磚|发各种军用子弹|发假2代身份证|发1代假冒身份证|发任意號碼變號|发供应白粉|发供应搖頭丸|发肾脏|发警用品|发最新版的假鈔|发乳胶脸皮|发真身份证|发个性号码改号|发精仿三棱軍刺|发供应冰鉆石|发手机x卧底改良版|发精仿尼泊爾軍刀|发供应间苯三酚|發提供冰毒|发乳胶面具|发真壹代身份证|发手機監聽軟件|发手機x臥底專業版|发95式步槍|发蝴蝶刀|发缅古|发二代假身份證|发精仿大马士革钢刀|发真实一代身份證|发供应迷魂药|发猎刀|发易容脸皮|发假一代身份證|发手機變號器|发一代個人身份证|发usb电视棒|发改号软件|发供应冰磚|发供应左旋麻黄素|发彩信改號|发牙签果子|发手铐qq|发警用电警棍|发进口硅胶面皮|发任意号码改号|发精仿鷹飛淩軍刀|发黄白牙签|发小冰砖|发人造脸皮|发二代個人身份证|发警棍|发潜伏者手机监听软件|发供应盐酸羟亚胺|发易容面皮|发高仿脸皮|发1代高仿身份證|发一代假冒身份證|发假冒二代身份證|发假币qq|发水果冰|发易容人皮|发高仿人皮|发1代假冒身份證|发一代精仿身份證|发汽狗|发仿真人皮|发手機變號機|发供应摇头糖|发供应海洛因|发手機改號軟件|发真一代身份證|发假冒1代身份证|发假冒2代身份证|发一代假身份证|发二代精仿身份证|发潜伏者改良版|发军用匕首|发一代精仿身份证|发高清usb电视棒|发007间谍增强版|发真实1代身份證|发供应high粉|发二代精仿身份證|发假冒壹代身份证|发手机变号器|发军刀|发冰毒qq|发超高压电警棍|发個人一代身份證|发假冒1代身份證|发改號軟件|发炸药导火索|发97式步槍|发真实一代身份证|发精仿尼泊尔军刀|发真壹代身份證|发真实2代身份證|发供应奶油冰|发一代假冒身份证|发潜伏者破解版|发銀行卡讀卡器|发万能开锁工具|量出售银行卡|发壹代高仿身份證|发2代高仿身份证|发一代高仿身份证|发真二代身份證|发供应間苯三酚|发供应摇头丸|发54式手槍|发一元硬币|发手机变号机|发真实1代身份证|发精仿大馬士革鋼刀|发供应小冰砖|发個性號碼改號|发供应氯胺酮|发64式手槍|发假冒2代身份證|发真身份證|发假冒身份证|发flexispy改良版|发精仿军用潜水刀|发仿真枪|发人皮面具|发仿真面具|发甲基苯丙胺|发個人1代身份证|发野战刀|发汽车解码器|发人造面皮|发假1代身份證|发个人2代身份證|发2代個人身份證|发彩信改号|发真实二代身份證|发供应黃牙簽|发供应白牙签|量收购银行卡|发一代高仿身份證|发個人1代身份證|发壹代高仿身份证|发手机007|发85式狙击步枪|发03式步枪|发美化面具|发精仿手工獵刀|发手机变号软件|发手机改号机|发手機改號|发最新台湾d版|发美化面皮|发个人1代身份證|发2代假冒身份证|发汽车遥控解码器|发個人2代身份證|发假身份證|发假冒一代身份证|发供应甲卡西酮|发03式步槍|发个性号码变号|发真实身份证|发精仿開山砍刀|发开锁工具|发個人一代身份证|发3d网络电视棒|发精仿兰博3号军刀|发警棍qq|发美沙酮|发进口硅胶面具|发高仿真面皮|发个人一代身份證|发供应king粉|发万能钥匙|发1代個人身份证|发1代精仿身份证|发供应乙醚|发军用手枪|发供应青蒿素|发警服qq|发手机改号器|发手機x臥底最新版|发成人电视棒|发手机改号软件|发供应麻谷|发供应麻黄素|发54式手枪|发高仿面皮|发1代假身份證|发一代假身份證|发1代精仿身份證|发精仿手工猎刀|发手機改號器|发k粉qq|发假冒二代身份证|发壹代個人身份证|发各種銀行卡|发精仿蘭博3號軍刀|发97式步枪|发军用手槍|发马古|发ghb水|发高仿面具|发美化人皮|发短信改号|发猎枪霰弹|发銀行卡|发任意顯號軟件|发砒霜|发硅胶脸皮|发假壹代身份證|发个人壹代身份證|发假壹代身份证|发指定號碼改號|发假冒一代身份證|发短信改号软件|发手机间谍|发銀行卡復制器|发手机碟中谍软件|发007间谍专业版|发潜伏者增强版|发供应麻黃素|发供应左旋麻黃素|发供应k粉|发k粉|发高仿真人皮|发指定号码改号|发真实壹代身份证|发精仿野营手斧|发个人壹代身份证|发身份證生成器|发供应麥角酸|发假硬币qq|发2代個人身份证|发1代高仿身份证|发手机窃听软件|发精仿美国m7军刺|发精仿蘭博求生刀|发高仿真脸皮|发假冒身份證|发精仿彈簧刀|发供应大冰砖|发一元假硬币|发冰毒|发仿真面皮|发壹代個人身份證|发壹代精仿身份证|发壹代假身份证|发64式手枪|发迷你网络电视棒|发精仿極端武力捕鯨叉|发供应鉆石冰|发供应胡椒基甲酮|发假钞|发假钱qq|发潜伏者专业版|发手機變號軟件|发真1代身份證|发硅胶面皮|发仿真脸皮|发易容面具|发指定号码变号|发手机007间谍软件|发壹代精仿身份證|发任意号码变号|发精仿兰博求生刀|发個人壹代身份證|发2代精仿身份证|发手机x卧底最新版|发缅果|发硅胶人皮|发乳胶人皮|发美化脸皮|发2代假冒身份證|发真实壹代身份證|发供应神仙糖|发供应冰毒|发二代高仿身份证|发真实二代身份证|发彩信改號軟件|发真2代身份證|发身份证制作原料|发精仿极端武力捕鲸叉|发92式手槍|发乳胶面皮|发硅胶面具|发假冒壹代身份證|发2代精仿身份證|发2代高仿身份證|发海洛因|发1代個人身份證|发flexispy最新版|发军警用具|发三唑仑片|发猎刀qq|发高仿假钱|发个人二代身份證|发精仿buck夜鹰平刃|发供应鹽酸羥亞胺|发警用电击棍|发间苯三酚|发壹代假身份證|发假1代身份证|发個人壹代身份证|发假2代身份證|发假二代身份證|发短信改號軟件|发指定號碼變號|发麻果|发二代高仿身份證|发假二代身份证|发信用卡復制器|发精仿美國巴克軍刀|发个人2代身份证|发供应三唑侖|发供应麦角酸|发铊盐|发個人二代身份證|发壹代假冒身份证|发彩信改号软件|发二代假冒身份证|发88式狙击步槍|发白黄牙签qq|发高清3d成人电视棒|发精仿貝爾求生刀|发供应黄牙签|发出售假币|发任意显号软件|发個人2代身份证|发精仿蝴蝶甩刀|发精仿野营军刀|发进口硅胶人皮|发2代假身份證|发假一代身份证|发手机监听软件|发高清网络tv棒|发真实2代身份证|发007间谍免费版|发全球网络电视棒|发供应大冰磚|发供应搖頭糖|发85式狙击步槍|发假钱|发假币|发进口硅胶脸皮|发精仿56軍刺|发短信改號|发供应神仙水|发任意號碼改號|发供应白牙簽|发高仿真面具|发一代個人身份證|发假身份证|发個人二代身份证|发手機改號機|发网络usb电视棒|发精仿野營手斧|发個性號碼變號|发供应麻古|发手机改号|发潜伏者免费版|发新版假鈔|发假硬币|发腎源|发二代假冒身份證|发壹代假冒身份證|发二代個人身份證|发真实身份證
贝|肉|尔求生刀专卖|领
俄|國|罗斯654k专卖|罗斯654k出售
魔|法师|障|难
兰|博ii号出售|博军刀出售|州军区|迪|桂情色帝国
廖|锡龙|福本|錫龍
传|单|大法|染性病
贼|民
軸|永康
来|电号码任意显示
给|你爽
沉|睡圖騰|富雄
資|本主義
左|轮手槍销售|旋麻黄素订购|旋麻黃素出货|旋麻黄素出货|旋麻黄素到货|不赔|轮手枪订购|轮手枪图纸|轮手枪銷售|旋麻黄素配方|轮手枪电话|旋麻黃素配方|营海军军官学校|轮钢珠狗出售|旋麻黄素送货上门|轮手枪到货|派|旋麻黃素送货上门|旋麻黄素出售|旋麻黃素订购|旋麻黃素到货|轮手枪出货|轮手枪出售|旋麻黃素供应|旋麻黃素销售|轮手枪qq|翼联盟|轮手枪制造|旋麻黄素合成
買|春|春堂|賣钢珠狗|賣汽車攔截器|賣鷹牌獵槍|胡椒基甲基酮|賣老虎頭獵槍|賣四氢吡喃酮|到槍
冈|村秀树|村宁次|山空军官学校|峦
漂|据|漂美眉
账|号
力|斯曼弓弩供应
導|師|彈
症|腐
耶|和华|稣|穌|苏|和華|酥
神|经病|仙糖配方|仙糖出货|仙糖送货上门|婆|經病|仙水送货上门|仙糖订购|仙水出货|仙糖销售|州行用户|通加持法|漢|仙水|仙水订购|仙水到货|仙糖到货|仙水销售|汉|风大乱交|仙水合成|仙水配方
遲|鈍的圖騰|浩田
諾|姆
閹|狗
讨|说法|债公司|伐中宣部
克|勞森|林頓|劳森|隆复制銀行卡|隆银行卡服务|林顿|萊恩|萊特|安德|莱恩|莱特|隆银行卡
吾|尔凯西|尔开希|尔开西|吉买买提|爾開希|尔
第|1色情基地|四色男人网|四色快播|四色黄色图|四色成人|一次破处|四代|21集团军
吴|定富|方城|百益|淑珍|帮国|向忠|宏达|敦义|育升|邦国|学璨|仪|胜利|学灿|弘达|志芳|官正|仁华
销|售步qiang子弹|售四氢吡喃酮|售各式小口枪|售韩国金狐手弩|售仿真来复枪|售仿真槍模|售司马系列气狗|售钢珠猎狗|售禿鷹汽槍|售高清3d成人电视棒|售pcp新贵手枪|售万能汽车解码器|售手枪子弹|售手弩|售cfx气枪|售m92f式手槍|售64式手槍|售单管獵槍|售防身高压电警棍|售军用钢珠弩|售高仿真人皮|售硅胶人皮面具|售铊盐|售健卫小口径步枪|售仿真人皮|售苯基丙酮|售溫切斯特1000x|售军用雷鸣登qq|售羟基环戊基|售槍支弹药|售加长两用弩|售全金属狩猎弓弩|售防身麻醉枪|售猎狗|售赵氏钢珠弓弩|售乳胶面具|售弹簧面具|售k粉qq|售盐酸氯胺酮|售钢珠弩|售眼镜蛇弓弩|售高仿真面具|售公司法人资料qq|售秦氏弓弩|售92手qiang|售各类银行卡|售电话营销数据qq|售高仿面皮|售网络电视棒|售银行卡qq|售ppk|售金钟气枪|售秃鹰|售氰化钾|售烟花爆竹|售三利达手弓弩|售麻醉箭弩|售弓弩弦|售仿真脸皮|售楼盘业主资料|售殷氏弩|售92手槍子彈|售连发猎枪|售假币|售54式|售两用中型弩|售獵qiang子彈|售77手qiang|售64手枪子弹|售枪支|售3d网络电视棒|售64式|售北朝鲜冰|售手驽|售力斯曼弓弩|售德国a1000|售獵槍|售硅胶面皮|售工字牌气枪|售车主资料qq|售短狗狗粮qq|售大冰砖|售战神弓弩|售铅弹气枪|售警用手铐|售军用手枪|售个人商务数据资料qq|售假一元硬币|售工字牌氣槍|售左轮手枪|售钻石|售台湾秃鹰|售捷克左轮|售公司法人资料|售老板通讯录qq|售军用狙击弩|售乳胶脸皮|售兽用麻醉枪|售钢制弩|售驽专卖|售自制式64式|售高仿真脸皮|售黄绿牙签|售三利达弓弩|售92手qiang子彈|售三箭气枪|售汽狗|售广州三箭气枪|售獵槍手槍|售易容面具|售猎枪|售77手槍|售虎头双管|售户外刀具|售烟花爆竹qq|售兄弟连弓弩|售娥眉气枪|售散弹槍|售乳胶面皮|售狩猎人弩|售左轮钢珠狗|售高仿真面皮|售猎枪子弹|售汽车解码器|售大冰砖电话|售45mm狗粮|售小口径步槍子弹|售64手枪|售硅胶脸皮|售黄体酮|售正品电视棒|售股民电话资源|售进口弓弩价钱|售猎豹弓弩改装|售鉛彈氣槍|售硅胶面具|售健卫14步枪|售全球网络电视棒|售车主名单|售法人通讯录|售股民资料|售钢珠弓弩|售工字牌汽槍|售军用弓弩|售麻古|售usb电视棒|魂洞|售楼盘业主资料qq|售股民资源|售户外狩猎弩|售便携式弩|售92手qiang子弹|售气枪|售车主名录|售黃牙簽qq|售虎头牌猎枪|售高仿面具|售钢珠手弩|售俄罗斯654k|售秃鹰汽枪|售lqb362|售连发猎qiang|售54式手槍|售小口径运动步枪|售步枪|售高壓氣槍|售64手槍|售仿真面具|售猎qiang子弹|售海豹m9|售水晶冰|售64手qiang|售仿真枪模|售發票|售军用狙击弓弩|售港38式左轮枪|售易容人皮|售人皮面具|售假钞|售车主资料|售弩狩猎网|售氯胺酮|售三箭牌汽枪|售假人民币|售迷彩大黑鹰弓弩|售连发钢珠弩|售cs狗|售散弹狗|售64手qiang子弹|售中控解码器|售人造面皮|售高档客户资料|售汽枪|售狙击钢珠专用弩|售64手qiang子彈|售92式|售车主名录qq|售狩猎弓弩|售进口硅胶人皮|售手枪|售一元人民币|售54手狗子弹|售麻醉qiang|售king粉|售警用品|售各类警用手铐|售廣州三箭氣|售92式手枪|售猎枪霰弹|售广州三箭|售可可精|售冰砖|售64式手枪|售易容面皮|售易容脸皮|售原装进口遥控干扰器|售92式手槍|售步枪子弹|售业主名单qq|售醱票|售子弹|售高压狗|售溫切斯特|售进口硅胶面皮|售手qiang子弹|售烟花qq|售老板通讯录|售力思曼弓弩|售袖珍手枪|售ffx氣槍|售烟花|售自製手狗|售人造脸皮|售唧筒式猎枪|售k粉|售户外狩猎弓弩|售港38式左轮|售獵狗|售54手qiang|售狩猎弩|售两用中型弓弩|售军用弩|售三步倒弩箭|售fx气皇|售仿真狙击枪|售赵氏驽|售双管平式枪|售左旋麻黄素|售仿真气枪|售赵氏钢珠弩|售手铐qq|售冰毒qq|售钢珠枪|售pcp新贵|售健卫步枪|售高压气枪|售64手槍子彈|售冰毒|售盐酸羟亚胺|售落榜生名单|售狩猎器材弩|售青蒿素|售防身警用电击棒|售54手枪子弹|售立式双管猎枪|售甲基苯丙|售麻古果子|售业主名单|售警用装备手铐|售弓弩之家|售自用电狗|售虎頭獵槍|售英国骚本气枪|售77猎枪|售健衛小口徑|售进口硅胶面具|售纯古|售92手枪子弹|售邻氯苯晴|售天然咖啡因|售狩猎者弩|售军用弩折叠弩|售92手枪|售手槍|售健卫小口径|售健卫小口径运动步槍|售仿真枪|售高仿人皮|售车主名单qq|售汽车遥控干扰器|售钢制弓弩|售獵槍麻醉槍|售散弹枪|售法人通讯录qq|售广州三箭气|售高仿脸皮|售单管猎枪|售小口径手枪|售弓弩|售高档客户资料qq|售防身电警棒|售过机假钞|售进口弓弩|售77猎槍|售美国秃鹰|售电击麻醉枪|售进口气枪|售金融客户资源|售掌心雷|售大威力弓弩|售92手槍|售猎qiang|售小口径手qiang|售麻古qq|魂|售折叠手弓弩|售m300|售钢珠狗|售进口气槍|售进口硅胶脸皮|售硅胶人皮|售迷你网络电视棒|售电话营销数据|售钢珠专用弩|售追风弩麻醉箭|售出售双管猎枪|售qi狗|售54手qiang子弹|售步qiang|售瓦斯手狗|售冰古|售仿cz75bd手枪|售乳胶人皮|售手狗|售高清网络tv棒|售胡椒醛|售个人商务数据资料|售假发票|售猎豹弓弩|售步槍手槍猎槍气槍|售手qiang
趙|品潞|曉微|紫陽|海青|建銘|南
抓|胸
谢|万军|中之|选骏|长廷|深山
拆|迁队
袭|近平|击
政|治反对派|俯|一府|治风波|权|治变革|治局常委|變|權|府|f|協|治犯|治诉求|治黑暗|治協商會議|体改造论|变|治反對派|付|腐|百度府|治|zhi|体改造|治老人|治协商会议
国|家机密|安局|际法院|产骚货|家安全|贼|新办主任|防科工委|家主要部委|内动态清样|产av|家民委|外办证|母|民大会|权|外破处门|研新闻邮件|家主席|产av片|外毛片|产小口径运动步槍出售|姆|务院|家领导人|民党万岁|产乱伦片|产无码|际特赦|之母|办发|防部|wu院|语运动|家安全局|产嫖娼|锋|产情色|管局|产毛片|军|峰|地税|家领导|产se情片|产偷拍|民党
制|服|幻剂出售|作假警官证|造假身份证|作左轮手枪|作氯胺酮qq|服狩|服美妇|作猎枪|作美国秃鹰|作防身武器|作高压气枪|作金钟气枪|作秃鹰汽枪|造冰毒|造特殊死亡|作仿真气枪|作新版警察证|作54式|造意外qq|作铅弹气枪|作虎头猎枪|服誘惑|造冰毒配方|作54式64式|作工字牌汽枪|作小口径步枪|作汽狗|服美婦|作64式|作k粉|作广州三箭|作证件|毒工艺|作健卫步枪|作盐酸羟亚胺|造缅古合成|作高仿面具|作三箭牌汽枪|作进口气枪|作冰毒|作氯胺酮|作台湾秃鹰|造的谎言|作虚假证件|作瓦斯手狗|作虎头双管|作45mm狗粮|作炸弹首先要制作炸药|作炸药|作仿真枪模|作秃鹰|作原子弹|造意外消失|式軍刀专卖|造意外死亡|作军用手枪|作三箭气枪
奖|金
访|民
周|小康|守訓|名军|总理|恩來|守训|恩来|永康|鋒鎖|生贤|旋|六性吧|天法|正毅|健康|锋锁
警|官证出售qq|用装备出售qq|用电击棒销售|用手铐货到付款|用品专卖网|服銷售|用手铐专卖|用电击棒销售qq|棍批发电话|服春秋执勤装出售|察知法犯法|用手铐qq销售|察特权|服出售|用电棍qq|用电击器防身供应|用手铐批发|服销售|服批发qq|服批发|用手铐出售网|服货到付款|服手铐出售|服电棒专卖|用电警棍批发|匪|棍销售|服电击棒专卖|用手铐qq|服出售电话|用手铐厂家直销|察证出售|棍批发|察开枪|察滥用职权|官证办理|匪一家|服电击棒专卖网|用电警棍出售|用品出售|用手拷出售qq|用催泪喷射器|用高压棍专卖|用电棍销售|用手铐出售|察|民冲突|察“不作为”|用电棍专卖网|用高压棍出售|用手电专卖|服专卖|奴|用电棍专卖|服出售qq
護|法|士誘惑
宏|志|法
尸|虫|蟲|龙|龍
嫖|客|妓指南|娼|妓
服|务管理|务器|务天使|務天使|務管理
泰|奴橋警衛兵|奴橋掠奪者
姣|西
要|人权,不要奥会|色色|射了
度|冷丁
避|孕套|孕
数|据中国
交|换人妻|班|友中心|媾|易赌博|通部|換夫妻|警警服出售|换夫妻|警|大高考招生黑幕|配
獻|祭的圖騰
q|q賣虎頭雙管|q賣金鐘氣槍|q供应冰毒|q卖高壓氣槍|q卖台湾秃鹰|q卖双管平式枪|iang支弹药购买|q专卖小口径手枪|q销售鉆石冰|q供应小冰砖|q供应黃牙簽|q賣健衛小口徑|q卖左轮手枪|q製作k粉|q卖54式64式|q卖獵qiang子彈|q卖ppk|q卖步槍|q卖獵槍|q订购奶油冰|q卖虎头猎枪|q卖防身麻醉枪|q卖64手qiang|q订购盐酸羟亚胺|iangjian|q卖仿真来复枪|q销售迷魂粉|q订购黄牙签|q专卖64手qiang|q供应小冰磚|q销售冰毒|q賣工字牌汽槍|q卖自製手狗|q卖麻醉qiang|q卖92手qiang子彈|q订购迷魂水|q销售甲卡西酮|q供应左旋麻黄素|q賣瓦斯手狗|q卖立式双管猎枪|q卖手槍|q卖92式手枪|q订购麻黄素|q供应钻石冰|q销售左旋麻黄素|q买卖冰毒|q賣cfx氣槍|q卖步qiang子弹|q卖工字牌汽槍|q订购麦角酸|q供应high粉|q销售胡椒基甲酮|q卖猎枪|q卖司马系列气狗|q销售黃牙簽|q订购麻古|q销售king粉|q卖广州三箭气枪|q卖64式|q卖散弹槍|q卖77猎枪|i狗出售|q卖钢珠狗|q订购白牙签|q供应奶油冰|q卖散弹枪|q供应摇头丸|q销售神仙糖|q专卖小口径步qiang|q卖瓦斯手狗|q订购海洛因|q销售間苯三酚|q销售k粉|uannengshenjiao|q卖出售双管猎枪|q卖77猎槍|q订购king粉|q销售搖頭糖|q卖高压狗|q订购乙醚|q供应迷魂药|q订购氯胺酮|q订购high粉|q卖英国骚本气枪|q销售青蒿素|q销售54手qiang|toy.com|q卖娥眉气枪|q卖92手qiang子弹|q出售银行卡|q销售小冰砖|ixingnet.com|q卖pcp新贵|q卖92式手槍|q销售奶油冰|q卖进口汽狗|q销售鹽酸羥亞胺|q订购鹽酸羥亞胺|q供应氯胺酮|q销售64手qiang|q卖广州三箭气|ingsewuyuetian.1174.net.cn|q卖92手枪子弹|q销售神仙水|q卖铅弹气枪|vod成人|q军刀网|q卖45mm狗粮|q销售迷魂藥|q销售大冰砖|q賣進口汽狗|q订购左旋麻黄素|q供应迷魂藥|q专卖77手qiang|q賣45mm狗糧|q制作冰毒|q专业办假证|q订购迷魂药|q供应三唑侖|q供应冰磚|q专卖小口径手qiang|qsg.org|vod援交片|q销售麦角酸|q卖防身武器|q卖美国秃鹰|q供应大冰砖|q买销售虎头猎枪|q卖健衛小口徑|q卖广州三箭|q卖64手枪子弹|q卖92手槍|q卖64手qiang子彈|q卖64手枪|q供应搖頭糖|q卖鉛彈氣槍|q供应盐酸羟亚胺|q销售左旋麻黃素|q銷售k粉|q卖袖珍手枪|q卖仿真槍模|q销售小冰磚|q销售冰砖|q供应甲卡西酮|q专卖92手qiang|q订购青蒿素|q订购甲卡西酮|q销售迷魂药|q销售冰钻|q销售黄牙签|q订购三唑侖|q销售仿真枪|vod情色电影|q假币出售|q卖单管猎枪|q制作k粉|q卖健卫小口径|q供应间苯三酚|q賣54式64式|q卖金钟气枪|q裸聊|q卖獵槍麻醉槍|q卖64手qiang子弹|q订购麥角酸|q销售海洛因|q销售间苯三酚|q供应大冰磚|ingzhen|vod性爱视频|q销售大冰磚|q订购麻谷|q订购黃牙簽|q销售迷魂水|q供应左旋麻黃素|q销售摇头丸|q供应神仙水|q供應k粉|q小口径手枪专卖|q卖虎头双管|q卖自用电狗|q卖左轮钢珠狗|q卖肾|q订购麻黃素|q销售92手qiang|q订购左旋麻黃素|i槍专卖|q卖工字牌氣槍|q卖獵槍手槍|q卖仿真狙击枪|q卖虎頭獵槍|q卖禿鷹汽槍|q卖64手槍|q订购鉆石冰|q销售麻黄素|q供應冰毒|q供应迷魂水|q销售77手qiang|q買銷售虎頭獵槍|q卖92式|q订购大冰磚|q销售麻谷|q卖钢珠猎狗|q供应钻石|q订购白粉|q销售氯胺酮|q賣防身武器|q賣高壓氣槍|q视频裸聊|q订购小冰砖|q订购間苯三酚|q出售安乐死药|q裸聊视频|q卖步qiang|q卖64式手槍|q卖64式手枪|q订购胡椒基甲酮|q销售白粉|q供应海洛因|q賣鉛彈氣槍|q賣禿鷹汽槍|q供应king粉|q供应白牙签|q供应迷魂粉|q賣廣州三箭氣|q卖秃鹰汽枪|q假钞出售|q卖廣州三箭氣|q供应麻黄素|q专卖小口径步枪|q賣熱武器|q卖手狗|q製作冰毒|q订购冰毒|q订购k粉|q供应神仙糖|vod激情电影|q卖子弹|q销售冰磚|q订购小冰磚|q订购迷魂藥|q訂購鹽酸羥亞胺|q卖64手槍子彈|q订购冰磚|q供应冰砖|q供应白粉|q卖工字牌汽枪|vod幼交片|q卖散弹狗|q卖92手槍子彈|q订购间苯三酚|q订购大冰砖|q销售麻黃素|q销售麻古|q賣仿真槍模|q订购白牙簽|q订购神仙糖|q供应搖頭丸|q供应青蒿素|q供应麻古|q代开发票|q供应摇头糖|q订购迷魂粉|q供应鹽酸羥亞胺|q销售搖頭丸|q賣獵槍|q卖仿真枪模|gqm.org|q供应黄牙签|q供应乙醚|q供应麥角酸|q销售三唑侖|q销售白牙签|q卖cfx气枪|q卖麻醉枪|q卖92手qiang|q订购搖頭糖|q订购摇头糖|q供应k粉|q订购摇头丸|q销售high粉|q卖高压气枪|q供应麻黃素|q销售盐酸羟亚胺|q供应麦角酸|q供应間苯三酚|q賣左輪手槍|q卖92手枪|q供应冰鉆石|q供应胡椒基甲酮|q销售钻石冰|q专卖54手qiang|q賣合成k粉|q订购钻石冰|q销售白牙簽|q销售乙醚|q供应白牙簽|q销售摇头糖|vod在线成人电影|q供应麻谷|q销售麥角酸|q订购搖頭丸|q订购冰砖|q订购神仙水|iang支出售
電|話77手qiang子彈qq|話步qiang子彈qq|話手qiang子彈|話92手qiang子彈|話92手qiang子彈qq|話64手qiang子彈|視流氓|話步槍子彈|話獵槍子彈|話步qiang子彈|話54手qiang子彈|話54手qiang子彈qq|話手qiang子彈qq|話獵qiang子彈qq|話64手qiang子彈qq|話獵qiang子彈
亚|洲无码av下载|洲bt无码|洲无码视频|洲淫色|洲无码电影下载|历山大|热|洲a片|热bt|热合集|洲双穴插入|洲情色网|洲色图|洲原创|洲淫图|洲性爱|洲色片|洲贴图区|洲bt|洲无码|洲色情|洲有码|洲女优|热迅雷|洲成人贴图区|洲插穴图|洲色站大全|洲转帖区|洲无码区|洲成人无码|太假人民币出售|情|洲色|洲性虐|洲美女做爱色图|洲淫娃|洲时报|洲av无码|洲性交电影
賀|國强|龍|國強|過牆
报|禁|码聊天
酐|乐欣
户|外刀具批发网|外军刀销售qq|外军刀|外狩猎弩qq|外军刀出售
t|riangleboy|.m.d|ibetalk|riangle|hegateofheavenlypeace|nt炸弹制作方法|nt炸弹制作|angjiaxuan|ringel|he9city|9wg.cn|nt|uidang|nnd|ianlong4f.cn|wfalundafa|estosterone|nt炸药制作|he9uj|aip|hec.cn|ibet|nt炸药制作方法|nt买卖|nt炸弹的制作|nt炸弹|aiwanduli|wdl|b.hi.4024.net.cn|itor|aobao|een|iananmen|he9|md|ont.cn|xwswind|ianwang|okyohot|est|aidu|nt配方
咪|咪图片|咪|咪圖片|咪娱乐|咪色色网
公|安机关处理邪教问题知识手册|产党|安部|开信|检法|告|关删除百度信息|媳乱|安|民私权|安秩序搞乱|头|道话|司快速代办|媳亂|关|投|款|安局|检法流氓
羅|福助|幹|禮詩|文嘉|志明|榮桓
军|刀直刀军品网|转干部|刀出售|品刀具批发|刀专卖|用手槍出售|用步枪出售|事社|官证出售|用手枪买卖|用匕首|用手枪专卖|用弓弩公司|转|用弩qq|用手枪出售qq|刀专卖qq|品54式手枪出售|用手枪专卖网|用枪专卖店|用弩货到付款|用弓弩专卖店|转安置|用弓弩专卖网|用手枪电话|刺专卖|用匕首出售|用刀具专卖|用手枪到货|用手枪出货|用弓弩批发|刺军品网|长发威|用64提供|刀匕首直销网|妓|用手枪qq|用枪支出售|品92式手枪出售|用步枪销售|用枪qq|用阻击弩|品64式手枪出售|用手枪订购|用狙击弩专卖|刀直销网|用手枪制造图|用刀具军品网|刀专卖�|用手枪销售|警用品专卖|用弩专卖|国主义
慢|驶
磁|条坏|卡压纹机|卡卡面印刷机|卡激光全息防伪图像|条|头坏
鞑|子
刷|卡成功|卡消费
借|第二代身份证攻击我党和政府
内|射|斗|争人权|蒙古5.11|射少妇|射美妇|裤|部透密|蒙古国|蒙古独立|部测试专用|衣丝袜|射小姐
蛩|鼽
內|褲|衣|射|射美婦
項|懷誠|小吉
钟|山风雨论坛
欧|洲无码|美成人片|美bt|美有码|美性交猛图|美gv|美情爱|美成年色情片|美贴图区|美成人贴图区|广源|洲无码av下载|美电影|洲bt无码|美无码原创|美色图|美转帖区|美援交|美无套|美色片|美性爱爽片|美性爱图库|洲色图|美se情片|美大乳|美无码区|美色情片迅雷下载|美内射|美原创|美无码|美自拍
慈|心佛性
騷|浪|浪美女|棒|貨|妹妹|浪人妻|包|棍|乳|姐姐|穴怒放|屄|母|b|女|妻|婦掰b|逼|媽|穴|b熟女|水|洞|女叫春|婦露逼|鶏|卵|妹|姨媽
达|米宣教会|杜拉|賴|癞|菲鸡|赖|赖喇嘛
羞|耻母|恥母
酷|刑|行
民|泽江|主墻|猪|联|选参政|族弩的制作方法|意論壇|國|陣|运|主墙|意论坛|航局|主党|聯|警|一主|主黨|国|竹|进党|怨|珠|爆器材|生危机|运领袖|進黨|主潮|運|阵|族矛盾|运人士|政部|主
谋|杀
淘|宝出售|宝
歐|美無套|美bt|美大乳
错|比|那吗b|那吗逼|那吗比|b|逼
龍|虎豹|火之心
呆|卵|逼
捌|玖
钦|定接班人|点接班人|本立
猛|插|操狂射|男|操|料
侍|從貝赫爾特|從倫斯韋
检|察院
记|者赵子法
档|案局|中央
著|名精品折刀出售
賴|士葆|昌星
催|情药|眠迷幻药
韩|国三级色情片下载|国援交|国a片|东方|国狗|联潮|正
试|题答案
植|物冰出售|物冰qq|物冰出售qq
騎|你
松|岛枫|岛枫迅雷下载
鑽|插
怒|干大骚女
破|处|坏大法|迷与正心|坏|處|处视频|鞋
動|亂|漫色圖|乱
更|衣
紫|阳
名|学府文凭|刀网出售|模尊享
懂|文华
現|金|金交易|代情色小說
窮|逼
娼|妓
自|主择业人员|制手枪|治机关|制巡航导弹|已的故事|然功|由运动|杀式爆炸|制弩机方法|制枪|慰抠穴|拍写真|製手狗出售|民黨|慰摳穴|动跳刀专卖qq|慰|製手槍出售|製手狗|製762mm手狗|制手槍买卖|制手枪销售|由时报|制手槍仿真|制炸药出售|製手槍销售|制弩机|救会|fen|由西藏|制原子弹|治区党委|制燃烧弹方法|焚|由圣火|制雷管|制式64式出售|制手槍出售|摸|治機關|主择业军官|制手枪出售|由民主论坛|由亚洲|由门|拍寫真|制组装枪支销售|制气枪图纸|民党|拍|用电狗出售|制手狗|插小穴|杀指南|由民主論壇|由亚洲电台|由通任意显|sha|由亚州|制炸药|制c4|制枪支销售|拍美穴|废|杀手册|製58mm手狗
進|口氣狗销售|口氣狗出售
可|知道对方通话|卡叶|待因|过机假钱qq|过机假钞qq|卡因|窃对方
楊|月清|周|思敏|懷安|建利|巍
漁|夫菲斯曼
茳|民|泽民
迷|藥|魂藥配方|魂粉送货上门|魂粉到货|魂藥出货|药|奸粉|信|奸药出售|魂药出售|幻藥销售|魂水订购|魂药配方|水|奸视频|魂水送货上门|魂藥到货|魂水出货|情|昏药|奸香水出售|魂药送货上门|魂藥送货上门|魂粉订购|魂|奸系列|奸药|情水出售|你网络电视棒出售|魂药到货|幻藥|失少女天堂|魂水到货|魂药出货|魂藥订购|魂粉出货|幻药|奸|情液|魂药|歼药|幻药香烟型|你网络电视棒电话|魂药订购|幻喷雾|幻香烟
独|夫民贼|立西藏|立台湾会|立|夫|派|裁|载
床|上功夫|第教战|上猛男
曹|刚川|政|長青|剛川|长青
马|加爵|英九|经|飚|良骏|凯|克思|的|白勺|会|恺|营|亚莲|嘉爵|继深|报|大维|卖马屁|特斯|永成|三家|列党|志鹏|时敏|古配方
馮|東海|素英
皇|軍|冠网赌球|冠平台出租|家花园|冠在线投注|城国际娱乐城|冠足球|冠投注网|冠开户|冠博彩有限公司
省|人大副主任
劳|教|动教养所|动保障部|教所|拉|工|改
兽|欲|奸|交|兽门|性|用猎枪出售
盗|取|撮|窃犯|窃
浑|圆
偷|录|歡|窺視頻|窺圖片|欢|拍美穴|渡|听器|窥|窥图片|窥视频|情|税|拍|越边境|窥社区
博|彩乐透乐|訊|彩|讯|彩城|彩娱乐|斯琴|作义|彩网络|彩论坛
輔|助程式
赤|匪|裸天使|化|裸中国|裸|色騎士|色戰士|党|龙
我|爱幼幼论|日|要性交|就色|妳老爸|爱你亚洲妹社区|和僵尸有个约会之僵尸始祖|操你|就去色|的后讨伐中宣部时代|日你|要性交网|爱我色网址|靠|操|干|爱狐狸精|的缠绵往事
嚴|家其|家祺|家淦
门|安天|徒会
袖|珍手枪出售
激|情视频聊天室|情电影种子|情大片|情藥品|情视频|情美女聊天|情成人游戏|情免费裸聊|情聊天|情小电影|情陪聊|情小說|情|情真人裸聊|情潮喷|情vip电影|情聊天室|情影视|情潮噴|情裸聊室|情片段|情开心网|情网|情电影|流中国|情视频在线看|情妓院|情a片下载|情裸聊网|情小说|情打炮|插|情小说迅雷下载|情裸体|情裸聊|情貼圖|情電影|情美女脱衣视频|情网网址|情视频聊天|情美女|情伦理|情少妇|情裸體|情成人网络电视|情片下载|情qq视频|情裸女聊天室|情视频下载|情裸聊视频聊天室|凸走光|情交友|情真人陪聊|情贴图
堕|淫
陶|驷驹
城|管|管暴力执法
鸿|泰通讯|达通信|宇通讯
奇|淫宝鉴|淫寶鑒|洛格
摳|穴
瘋|狗|狂抽送
五|连发猎槍专卖|连发猎枪专卖|连发猎枪销售|連發獵槍销售|毛党|连发猎枪出售|不|至七步功|星红旗|连发猎qiang出售|月天|毛们|连发猎槍出售|連發獵槍出售|毛
迪|裏夏提|里夏提
善|惡有報|恶有报
罢|餐|运|考|食|市|驶|ke|教|吃|学|工|课|饭|参
炭|疽病毒
仆|街
喬|石|伊
胴|体
邦|国
人|民內情真相|权奖|quan|民真实报|民内情真相|类灭亡进程表|妻|体摄影|妻色誘|妻小说|木又|权圣火停止迫害|民大会堂|代|妻内射|民大众时事参考|民报消息-越南|妻不伦|妻激情|兽情|兽杂交|妻交換|皮专卖|权圣火|妻交换|大|权|渣|民真实报道|皮面具供应|妻榨乳|民報|民代表|与兽性交|性本色|民之聲論壇|民日报|體攝影|造面皮qq|民真實|大代表|民代表大會|皮面具电话|妖妹妹|造面皮货到付款|妻俱乐部|肉炸弹|妻做愛|弹|妻中出|皮面具出售|妻做爱|兽|民之声论坛|妻乱伦|妻熟女|權|民真实|兽交短片|民广场|民银行|物|皮面具定制|皮面具货到付款|民大會堂|拳|民|皮面具qq|造脸皮货到付款|体艺术|民报讯|代会|大常委|造脸皮qq|妻自拍|体炸弹|民代表大会|民报|妻色诱
粗|制吗啡|口歌
岗|哨士兵
逼|样|羊为狼|好痒|格|穴|奸|癢|你老母|孕|孕套|樣|痒|毛|真女下体
鮮|族
八|九学潮|九学运|九年|旗娱乐网|九风波|老|九學潮|九民运|九运动|路|婆|四纲领|亿人民都是批判家|九
弄|穴
董|文华|贱华|光峰|建华|必武|文華
饥|渴少妇
多|党|維|p视频|人轮|维新闻网|功能sim卡|人换妻|功能折刀专卖|维|人性愛|黨|人輪|功能手机卡|人群交|人乱交|人杂交
分|隊長施蒂文|裂|家在|裂祖国|裂国家
莫|偉强|伟强|达非尼|索里尼
爸|爸的新娘
官|场日志|逼民反|方|匪|商勾结
哲|民|蚌寺
满|狗|洲第三帝国
足|脚交|腳交|球下注
犬|神
學|生妹|潮|聯|運|自聯
火|辣圖片|辣寫真|药出售|药动力钢珠枪出售|乍|炬|箭系统|棒|药|药配方|药当面交易|药专卖|辣写真|暴|车票|药看货付款|辣图片
潮|喷|吹|噴|吹女王
漢|奸
懷|特
販|毒
粥|永康|健康
溫|切斯特订购|切斯特qq|b|比|切斯特到货|切斯特1000x电话|切斯特1000x出货|切斯特1000xqq|切斯特出售|家寶|元凱|切斯特电话|逼|切斯特出货
屙|民
邝|锦文
孙|大千|中山|文|逸仙|家正|永波|政才|春兰
亲|日|美|蛋蛋|吻蛋蛋|民党
褲|襪
汇|款到
侦|探公司|探设备|察证qq|探专家
爺|爺
粉|穴|嫩小洞|嫩小穴|嫩的小沟|碎四人帮|紅穴|红穴|屄|飾太平|嫩|饰太平|红小b|红小逼
处|女终结者|女膜|女开苞视频|女出售|女的诱惑|女嫩穴奸淫|女破处直播|男出售|女穴|女开包|女|男
樱|井
挨|球
蛮|子
罗|箭|永忠|文嘉|志明|荣桓|礼诗|长福|福助|干
虐|奴|待|恋
帳|號
抡|功
歪|理邪说
佛|蘭克林|教|祖|展千手法
下|体|流地帶|载手机窃听软件|注|贱|流地带|賤|體|盘|面的唇
蘚|鮑
拳|交
个|人身份信息出售|性号码改号|性号码变号|性号码改号软件|人崇拜|人资料
残|害法轮|害法轮功
进|口汽狗专卖|口三唑仑片出售|口气狗销售|口麻醉槍销售|口硅胶面皮qq|口硅胶脸皮货到付款|口气槍销售|口双管枪qq|口气枪出售|口秃鹰专卖网|口气枪到货|口手机卧底软件|口硅胶人皮货到付款|口硅胶脸皮qq|口气槍专卖|口气枪制造图|口气枪qq|口气枪出货|口硅胶面具qq|口硅胶人皮qq|口气枪|口气枪订购|口气枪电话|口弓弩专卖|口硅胶面具货到付款
监|督|听器软件下载|狱|禁陵辱|管|听王|察院|视器|听手机qq
鬧|事
在|线办理证件|十月|线真钱游戏|线赌博|线现金博彩|线博彩|线视频裸聊|线六合彩|线成人电影|线老虎机|线真钱博彩|线裸聊|线激情电影|线百家乐|家里做原子弹的方法|线下注|线现金娱乐
罚|没|款黑幕
造|爱|反|愛|业
涂|运普
为|了忘却的纪念
卵|蛋|子
f|alundafa.|apiao|alundafa|reechina|y371.com|enlie|lexispy专业版|lexispy下载|lexispy免费版|isonet.com|alundafa.org|l功|aggot|apiao大量供应|x气皇出售|lexispy改良版|a lun gong|uck|uck,共产党,urban,我操,cao,他妈的,tmd,鸡巴,煞笔,傻b,法轮功,江泽民,胡锦涛,温家宝,urban-rivals,rivals,我日,ur,ur,性交,口交,婊子,妓女,,她妈,牛逼,牛b，牛比,煞笔,傻逼,傻b,操你妈,装逼,装b,日你妈,不玩了,删号,卖号,删号,妈的,妈逼,草你妈,t.m.d,jb,jb,,出售账号,出售此号,卖号,u/r,u-r,j8,吗的,8仙,狗日,出售神符,色情,黄色,藏独,台独,法轮大法,鸡巴,毛泽东,npc,*法*轮*功*,*李*洪*志*阿扁,阿扁万岁,阿拉,阿拉法特,挨球,安南,安全局,澳洲光明网,八九,八九风波,办理文凭,办理证件,包皮,保钓,保监会,保密局,鸨,鲍岳桥,暴动,暴乱,暴徒,北京之春,贝肉,本?拉登,本?拉登,苯比,笨屄,笨逼,屄,屄毛,逼毛,逼你老母,逼样,比毛,婊,婊子,宾周,冰毒,波霸,博讯,薄一波,布莱尔,布雷尔,布什,布什,财政部,参事室,藏独,藏独,藏独,操,操gm,操gm,操gm,操gm,操xx,操逼,操比,操蛋,操你,交媾，cao，k粉，j8，小姐兼职，交媾，西藏314事件，新疆7.5事件，乱伦，毛片，黄片，交配，群交，小姐兼职，茉莉花革命，操你八辈祖宗,操你妈,操你妈屄,操他,曹刚川,草的你妈,草妈,草你妈,草拟妈,肏,测绘局,插gm,插gm,插gm,插gm,插妳,插你,插你妈,插深些,产权局,朝鲜,车臣,车仑,陈功,陈良宇,陈水扁,陈希同,陈晓宁,陈毅,陈至立,成人电影,成人片,吃大便,吃屎,迟浩田,赤匪,抽插,抽你丫的,臭化西,出售假币,出售枪支,出售手枪,吹喇叭,吹箫,春药,蠢猪,戳你,粗制吗啡,催情药,达赖,达赖喇嘛,打炮,,大b,大逼,大便,大波波,大麻,大麻树脂,大麻油,大师,戴维教,大学骚乱,大血b,大血比,呆卵,戴海静,戴红,戴晶,戴维教,党主席,荡妇,档案局,盗窃犯,盗窃犯,道教,邓小平,帝国主义,电监会,叼你,叼你妈,屌,屌7,屌鸠,屌毛,屌妳,屌七,屌西,钓鱼台,丁关根,丁子霖,东北独立,东升,东条英机,东突,东突暴动和独立,东突组织,东亚病夫,董建华,董贱华,董文华,懂文华,独立,独立台湾会,恩格斯,二b,二屄,二逼,二乙基酰胺发抡,发抡功,发伦,发伦功,发轮,发论,发论公,发论功,发骚,法(轮)功,法*轮*功,法功,法愣,法仑,法轮,法轮大法,法轮功,法西斯,法制办,反动,反革命,发票，冰粉，性奴，反共,反华,反恐委员会,反日,反政府,分裂祖国,佛教,佛展千手法,佛祖,斧头镰刀,阝月,傅鹏,傅作义,干gm,干gm,干gm,干gm,干拎娘,干妳,干妳老母,干妳妈,干妳娘,干你,干你妈,干你妈b,干你妈逼,干你娘,干七八,干死你,肛,肛交,肛门,港澳办,高俊,高丽棒子,高校暴乱,高校群体事件,高校骚乱,睾,睾丸,膏药旗,弓虽女干,公安,公安部,公安局,共产党,共产主义,共匪,共狗,狗b,狗操,狗卵,狗娘,狗屁,狗日,狗日的,狗屎,观世音,官逼民反,官商勾结,龟儿子,龟公,龟孙子,龟头,鬼村,滚,郭伯雄,国安局,国防部,国防科工委,国管局,国际法院,国家民委,国家主席,国家主要部委,国民党,国民党万岁,海洛因,海洋局,何候华,贺国强,贺龙,黑社会,黑手党,黑手党,黑手党,红卫兵,洪兴,洪志,后庭,胡xx,胡紧涛,胡紧掏,胡紧套,胡锦涛,胡锦淘,胡乔木,胡耀邦,胡主席,花柳,华国锋,华建敏,换妻,黄菊,黄菊,黄色电影,黄色小电影,回教,回良玉,回民暴动,回族人吃猪肉,昏药,火棒,机八,机巴,鸡八,鸡巴,鸡叭,鸡芭,鸡掰,鸡奸,基地组织,基督,基督教,激情电影,激情小电影,鸡,计牌软件,计生委,妓,妓女,妓院,贾庆林,奸,奸夫淫妇,奸你,奸淫,贱,贱逼,贱货,贱人,江core,江八,江八点,江独裁,江核心,江青,江戏子,江择民,江泽民,江贼民,江折民,江猪,江猪媳,江主席,僵贼民,疆独,蒋介石,蒋经国,蒋中正,酱猪媳,交通部,姣西,叫床,叫鸡,叫小姐,教育部,她妈的金日成,金正日,禁书,经济社会理事会,经社理事会,精液,精子,警匪一家,敬国神社,靖国神社,静坐,纠察员,鸠,鸠屎,军长发威,军国主义,军妓,尻,靠,靠你妈,靠腰,可待因,可卡叶,可卡因,克林顿,恐怖份子,恐怖主义,口交,寇晓伟,狂操,狂操你全家,拉登,拉姆斯菲尔德,懒教,烂b,烂屄,烂逼,烂比,烂屌,烂货,劳+教+所,劳动保障部,老逼,老毛子,老母,黎阳评,李长春,李登辉,李弘旨,李红志,李宏旨,李宏志,李洪志,李岚清,李鹏,李鹏*,李瑞环,李山,李铁映,李先念,连战,联大,联合国,联合国大会,联易,联易互动,粮食局,两腿之间,列宁,林彪,林业局,刘淇,刘军,刘淇,刘少奇,刘云山,流氓,六.四,六。四,六?四,六合彩,六四,六-四,六四事件,六四真相,龙新民,吕秀莲,旅游局,卵,轮功,轮奸,罗干,罗干,骡干,妈逼,妈比,妈卖妈屁,妈批,妈祖,妈b,妈的,麻醉钢枪,麻醉枪,麻醉药,麻醉乙醚,马克思,马卖马屁,马英九,吗啡,吗啡碱,吗啡片,买财富,买卖枪支,麦角酸,卖.国,卖b,卖id,卖qq,卖逼,卖比,卖财富,卖党求荣,卖国,卖国求荣,卖号,卖卡,卖软件,卖淫,毛xx,毛厕洞,毛一鲜,毛泽东,毛贼东,毛主席,梅花网,美国,美国佬,美国之音,美利坚,蒙尘药,蒙独,蒙古达子,蒙古独立,迷魂药,迷奸药,迷歼药,迷药,密洞,密宗,民航局,民进党,民运,民政部,明慧网,摩门教,莫索里尼,穆罕默德,穆斯林,乳头,奶子,妳老母的,妳妈的,妳马的,妳娘的,南联盟,南蛮子,南蛮子,嫩b,嫩b,伱妈,你爸,你大爷,你二大爷,你老母,你老味,你姥,你姥姥的,你妈,你妈逼,你妈的,你娘,你爷爷的,鸟gm,鸟gm,鸟gm,鸟gm,鸟你,牛逼,牛比,农业部,虐待,拍肩神药,喷你,彭真,皮条,屁眼,嫖客,苹果日报,破坏,破鞋,仆街,普京,气象局,钱其琛,枪决女犯,枪决现场,枪支弹药,强奸,强奸犯,强卫,强效失意药,强硬发言,抢劫,乔石,侨办,切七,窃听器,窃听器材,亲民党,青天白日,情色,去你妈的,去死,全国人大,瘸腿帮,人大,人大代表,人代会,人弹,人民,人民大会堂,人民广场,人民日报,人民银行,人体炸弹,日gm,日gm,日gm,日gm,日x妈,日本ring,日本鬼子,日你,日你妈,日你娘,日他娘,肉棒,肉壁,肉洞,肉缝,肉棍,肉棍子,肉穴,乳,乳波臀浪,乳房,乳交,乳头,撒尿,萨达姆,塞白,塞你爸,塞你公,塞你老母,塞你老师,塞你母,塞你娘,三个呆婊,三个代婊,三级片,三民主义,三陪,三陪女,三去车仑,三唑仑,骚,骚b,骚逼,骚货,骚,色情,色情电影,色情服务,色情小电影,杀人犯,傻b,傻屄,傻逼,傻比,傻吊,傻卵,傻子,煞逼,商务部,上妳,上你,社科院,射精,身份生成器,神经病,神通加持法,生鸦片,圣女峰,十八摸,十年动乱石进,食捻屎,食屎,驶你爸,驶你公,驶你老母,驶你老师,驶你母,驶你娘,是鸡,手淫,受虐狂,售id,售号,售软件,双峰微颤,氵去,水利部,水去车仑,税务总局,司法部,私服,私/服,私\\服,私服,私-服,私—服,斯大林,死gd,死gd,死gm,死gm,死全家,四川独立,四人帮,宋楚瑜,宋祖英,孙文,孙逸仙,孙中山,他爹,他妈,他妈的,他马的,他母亲,他祖宗,台办,台独,台联,台湾党,台湾帝国,台湾独立,台湾共产党,台湾共和国,台湾狗,台湾国,台湾民国,太监,太子党,唐家璇,天皇陛下,田纪云,舔西,投毒杀人,透视软件,推油,外挂,外挂,外/挂,外\\挂,外_挂,外挂,外-挂,外—挂,外汇局,外交部,外专局,晚年周恩来,万税,王八蛋,王宝森,王刚,王昊,王乐泉,王岐山,王太华,王兆国,王震,网管,威而钢,威而柔,卫生部,尉健行,温加宝,温家宝,温家保,温馨,温总理,文化部,文物局,倭国,倭寇,我操,我操你,我干,我妳老爸,我日,我日你,无界浏览器,吴仪,吴邦国,吴官正,吴仪,五星红旗,西藏独立,西藏天葬,希拉克,希特勒,希望之声,洗脑班,系统,系统公告,系统讯息,鲜族,乡巴佬,想上你,小鸡鸡,小泉,小泉纯一郎,小日本,小肉粒,小乳头,小穴,邪教,新疆独立,兴奋剂,性爱,性交,性虐待,性无能,性欲,徐光春,学潮,血逼,血腥图片,鸦片,鸦片液,鸦片渣,烟草局,严方军,阳精,阳具,摇头丸,摇头玩,耶和华,耶苏,耶稣,叶剑英,夜情,一党专制,一贯道,一国两制,一夜情,一中一台,伊拉克,伊朗,伊斯兰,以茎至洞,抑制剂,阴部,阴唇,阴道,阴蒂,阴核,阴户,阴茎,阴毛,阴水,阴小撕大,淫,淫荡,淫秽,淫货,淫贱,淫叫,淫毛,淫靡,淫水,淫娃,淫语连连,淫欲,英雄纪念碑,硬挺,邮政局,游戏发奖员,游戏宫理员,游戏管理员,游行,俞正声,舆论钳制,玉杵,欲火焚身,原子能机构,援交,远程偷拍,曰gm,曰gm,曰gm,曰gm,曰你,月经,月经不调,月经,扎卡维是英雄,杂种,造反,曾培炎,曾庆红,扎卡维,张朝阳,张潮阳,张德江,张磊,张立昌,张小平,赵紫阳,侦探设备,真理教,中国恐怖组织,中华民国,中南海,中宣部,周恩来,周永康,周总理,朱德,朱容鸡,朱容基,朱熔基,朱镕基,朱总理,猪操,猪容基,主席,转法轮,转法轮,装屄,装逼,追查国际,子女任职名单,自焚,自杀手册,自杀指南,自制手枪,自治机关,宗教,总局,总理,作爱,坐台的,做爱,共产党,江泽民,胡锦涛,温家宝,严方军,屄毛,操逼毛,东突,骚货,法轮功,江泽民,胡锦涛,温家宝,urban-rivals,rivals,ur,ur,我日,ur,ur,性交,口交,ur,taobao,webgame.com.cn,婊子,妓女,他妈,她妈,牛逼,牛比,牛b,煞笔,傻逼,傻b,你妈,操你妈,装逼,装b,日你妈,不玩了,删号,卖号,垃圾游戏,烂游戏,删号,妈的,妈逼,草你妈,t.m.d,jb,jb,淘宝,出售账号,出售此号,卖号,u/r,u-r,cao,j8,吗的,8仙,狗日,出售神符,色情,黄色,h站,龙虎,虎门,龙虎门,web牌戰,web战牌,战牌,8仙,ｕｒ,ur,ur,街头对抗,藏独,台独,法轮大法,混沌决,ur,ur,urban,鸡巴,坐台的,作爱,总理,宗教,自治机关,自制手枪|lexispy官网|lexispy|lexispy免费试用|fx氣槍銷售|eelmistone|eitengdl.com|a票|apiao销售|lexispy最新版|alungong|alu|a轮|reedom|xjsqc.com|uck靠|lexispy官方网站|ulankelin|alun|ku|reenet|lexispy增強版|lexispy增强版|x气皇专卖|alundafahao|lg|aluninfo|fx氣槍出售|lexispy免費版|lexispy破解版
原|装cfx气枪|装电动长狗|味丝袜|装汽狙狗|住民|教旨主义|装秃鹰气枪|装广州三箭|子弹的理论恐怖分子|湖北黄石民警吴幼明|子能機構|装仿真气枪|装狩猎气枪|子弹|子彈|子能机构|装工字牌气枪|装英国骚本|千寻|装pcp气枪|装娥眉气枪|装比赛用枪|味絲襪|装双管枪|装西班牙气枪|装气枪|装猎枪|子弹的diy制作|装锡峰气枪|装竞技气枪
消|防隊|灭共产党|业|磁|防队
魏|京生|新生
青|帮误国|天白日旗|海独立|蒿素配方|蒿素订购|天白日|帮误国真腐败|蒿素出货|蒿素送货上门|蒿素到货|蒿素销售|木友梨
扣|你妈
女|同性爱|孩上门|模招聘|死囚|马ㄉ|優|女|馬ㄉ|性自慰sex吧|技师服务|上门|尻|优|幹|体|马的|干|人穴|教师|警执行死刑|馬的|馬白勺|奴上门|马白勺|屄|主人羅姬馬莉
擇|民
定|税企业|做人造脸皮|做人造面皮|制人皮面具|购假钱|购假币
饅|頭屄
梵|欲|蒂冈
摸|阴蒂|你鶏巴|奶|胸|陰蒂|你|你鸡巴|你全身
科|萊爾|莱尔
赌|马|局|徒|恒指|场|城|骰子|博|球|钱
巧|淫奸戲|淫奸戏
盖|棺定论
请|命|愿|愿书|收听
姜|春云
密|宗|穴|室淫行|穴贴图|洞|穴貼圖
凸|人也|她|女也|你|我|妳|他|肉优|肉優
骆|海坚|冰淫传
遊|行|戲管理員
洗|脑班|腸射尿|肠射尿|腦|浴|码|脑|钱
洪|大慈悲|秀柱|傳|哲勝|吟|志|智|法|興|传|哲胜|兴
鶏|毛信文匯|女|八|巴|吧|奸|8|鶏|院
弹|劾|药|药配方|簧刀出售|簧刀匕首|簧人皮货到付款
熊|焱|炎
純|一郎
风|骚欲女|骚侍女|骚艳妇|月大陆全文下载|月大陆全文阅读|云六合|流岁月|水|尘劫|波记|雨神州论坛|山陆军军官学校|月阁|流教皇全文阅读|流逸飞|骚淫荡|骚|雨神州|花|月大陆|艳阁
抢|劫|粮记|取|夺
j|inzhengen|ian你|iaochun|iba|iangjieshi|iayyou.com|iuping|吧|iangdongriji|dyou.com|iangjingguo|jdlw.com|q的来|巴|iangzemin|8|i女|j.pangfangwuyuetian.hi.9705.net.cn|iayyou.cn|ieyan|j|iaqinglin|ooplay.com|iangqing|iangzhongzheng|b|iaochuang|ie严|inzhengri|inricheng|inv|inpaopao.com|zm
騙|局
河|殇|殤|蟹社会
星|野桃|岛日报|崎未來|崎未来
笨|七|柒|屄|逼|比|蛋
壹|代個人身份证|代假身份证|代假冒身份证|代精仿身份证
穆|斯林|罕穆德|斯林兄弟会|斯林国家|斯林世界|罕默德
車|侖|侖女幹
将|则民
王|超华|世坚|力利|輔臣|策|东明|润生|胜俊|立军|超華|冶坪|学军|金平|軍濤|刚|炳章|震|剛|晨|八蛋|希哲|建琪|锦思|洪文|军涛|安顺|振华|洛林|维林|岐山|丹|滬寧|沪宁|立軍|潤生|太华|子淫传|小丫老公|振|寶森|樂泉|宝森|瑞林|者弓弩专卖|兆国|凤友|力雄|涵万|乐泉|秀丽|若望|世勋|涵萬|志刚|辅臣|鸿举|昊|八|世堅|秀麗|兆國|世勛|千源
走|私|光偷拍|光|私枪支|入邪悟者|向圓滿|向圆满
濕|穴|身誘惑|了還說不要|了還說要
驴|b
潛|伏者免費版|伏者手機監聽軟件|伏者破解版
普|贤|选|通票|賢|通发票代开|京
拿|破仑|破崙
揉|乳|奶
尼|泊尔军刀专卖|克松|玛|奧夫|瑪|克森|奥夫
氢|弹
e|vent|周刊|rduoqiao|t成人網|ngesi|nt365.com|pochtimes.com|夜情俱乐部|erdeni|pochtimes|pochtpe@seed.net.|rdaoqiao|stazolam|ee.xaoh.cn|7sw.cn
丘|垂貞
藥|材商人蘇耐得|水
捅|你|我|b|逼|比|她
獸|交|奸|欲|獸門
维|独|吾|权|权人士杨春林|护权益|权联盟|多利亚公园|族|护|汉|基百科
w|ww.wow366.cn|ww.70yx.com|anglequan|ww.dy6789.cn|ujie.net|ww.zxkaku.cn|ww.766.com|ww.sf766.com.cn|uyi|ww.|ww.976543.com|ww.gamelifeclub.cn|ww.365jw.com|ww.sexwyt.com|y724.com|ww.dajiyuan.com|staij|oerkaixi|ww.foyeye.com|ww.2q5q.com|ww.gw17173.cn|ww.wang567.com|ww.567yx.com|ww.legu.com|gbobo.cn|angqishan|ww.99game.net|eb战牌|ww.yxnpc.com|ww.zsyxhd.cn|ww.yhzt.org|hoyo.com|enjiabao|anggang|angdan|ww.sanjidianying.com.cn|ww.315ts.net|g7766.cn|oyinwose.1243.net.cn|ebgame.com.cn|ww.ylteam.cn|y33.com|uguanzheng|ww.50spcombaidu1828adyou97sace.co.cc|ww.91wangyou.com|ww.978808.com|ww.anule.cn|ww.gardcn.com|eb牌戰|ubangguo|ebzen|ww|ww.xaoh.cn|eijianxing|ww.bin5.cn|ww.neicehao.cn|ww.23nice.com.cn|y3868.com|g|anghongwen|angce|staiji|gxiaowu.com|angzhaoguo|ww.89-64.com|ww.tibetalk.com|anglijun|ww.zy528.com|ww.maituan.com|angyoudl.com
緣|圈圈
送|养孩子|礼|养宝宝
折|刀砍刀专卖|刀砍刀军品网|叠狗qq|叠手弩配件|刀专卖
吃|翔|精|鸡巴|婴|屎|大便|雞巴
炮|灰|兵团|片|友之家|友|图
史|萊姆|萊姆王|達林
雜|種
測|試
改|号软件出售|号器qq|装ffx氣槍|号软件下载
扉|之阴|之陰
恶|女戏夫|党|党书记我坐在他的小腿上在中共治下的中国|搞公安部领导
鬱|慕明
砍|死你|刀专卖网|刀专卖店|刀出售|刀专卖|翻一條街|人|翻一条街
塞|白|你公|你娘|你爸|你老师|你老母|拉利昂|你母
墨|索里尼
做|爱|原子弹方法|愛圖片|愛自拍|爱视频|爱聊天室|爱电影|爱自拍|爱表演|愛|ai|硝酸甘油炸药|爱游戏|爱裸聊|爱图片|爱插入|鸡|帐|愛電影
清|真|华帮|真寺|zhen|海无上师|晰內射|除网络负面信息|晰内射
庆|红
散|弹枪买卖|散步|弹枪专供|弹槍出售|弹狗出售|弹枪出售
攻|击共党|占台湾|击党政
傅|申奇|鹏|作义|作義|锐|志寰|怡彬
高|爆炸药出售|压气槍销售|仿人皮qq|干|清裸聊现场|薪養廉|自联|清性愛|压狗出售|治聯|潮白漿|考考生信息出售|压电警棍批发网|偿领养|潮集锦|瞻|清3d成人电视棒出售|压气枪qq|压气枪到货|官|仿真面具qq|仿面具qq|仿真面皮qq|校文凭快速办理|智晟致胡温公开信|級逼|仿真人皮qq|仿脸皮货到付款|压麻醉枪出售|利息贷款|仿狙击枪专卖|薪养廉|仿真面具出售|考考生落榜名单出售|仿面皮货到付款|压气枪销售|级逼|仿人皮|清成人电影|压气枪制造图|档俱乐部会员资料|仿一元硬币出售|层权力之争|俊|校骚乱|价收肝脏|考生名单出售qq|治联|潮白浆|压气枪专卖网|文謙|仿毕业证|压警用电棍出售|仿真脸皮qq|压电警棍销售网|仿脸皮qq|勤荣|科信息|校暴乱|压电棒专卖网|考落榜名单|仿真假币销售|志晟|息不要|压气枪出货|压气枪订购|壓氣槍供應|仿真脸皮货到付款|压电警棍专卖网|价收肾脏|薪日结|利贷|仿枪专卖店|仿制作人皮面具|仿面具货到付款|压气枪出售|层生命|压警用电棍专卖|仿人皮货到付款|压气枪电话|丽朴|仿人皮面具专卖|智成|压气枪结构图|麗朴|消费名录|仿真面皮货到付款|仿真假钞出售|官互调|层人事变动|清usb电视棒手机|仿一元硬币购买|清成人电视棒官网|价求肾|价收腎源|壓氣槍出售|考考生信息出售qq|文谦|仿假鈔銷售|仿真人皮面具qq|科技赌具赌博工具|压电警棒供应|仿真面具货到付款|清网络tv棒出售|性能遥控干扰器|自聯|干子弟名单|效三唑仑|清av|价售肾|压电警棍出售|仿真乳胶面具|级仿真枪销售|价肾源|智晟|仿真人民币qq|价票|仿面皮qq|清3d成人电视棒电话|仿手枪销售|幹|潮|压狗qq|清网络电视棒电话|偿送养|丽棒子|官子女|仿真假钞销售|仿真假币当面交易|仿真人皮货到付款|清网络电视棒出售|清usb电视棒出售|压英国pcp骚本出售|仿人民币qq|管名录|清网络电视棒qq|校群体事件|压电警棍批发|壓氣槍联系qq|价收腎脏|清网络tv棒手机|清3d成人电视棒qq|麗棒子|潮集錦|清炮图|官挥霍公款
伱|妈
胺|吗啡出售
远|志明|程偷拍|程弓努专卖|程弓驽专卖
裝|逼|b
角|色
截|访
参|政传奇|谋本部|事室
释|欲|清海|欲堂|迦牟尼
哈|龟|尔罗尼|爾羅尼|批
陽|具|痿|物
離|長春
另|类电影|类群交|类色图
烂|比|货|b|屄|屌|游戏|袋|逼
賤|逼|比|貨|人|種|b|bi
梦|幻西游私服|幻逆玉王
膀|胱
荡|妇|女
阎|王|庆新|明复
不|玩了|爽不要钱|滅帝王|爽不要錢|解来电|影响对方
删|号|帖公司|除负面帖子|除负面信息|帖炒作公司|帖营销公司
职|业打手qq|业打手|业复仇|业报仇
素|人娘|人|人无修正
裆|中央
雨|伞运动
炼|功|大法
拨|968|9676|打9680
陈|绍基|定南|一文|光诚|小同|水扁|毅|至立|尧军|功|博志|学圣|军|一咨|德铭|破空|蒙|同海|总统|建铭|云|良宇|冠希|炳德|一谘|宣良|希同|景俊|晓宁|独秀|进|s扁|建国|唐山|炳基|秋兰|随便|菊
向|外代办|忠发
过|机版人民币qq
布|局十七大|希|雷尔|什|莱尔|萊爾|雷爾
薄|熙来|码|格|一波|碼|熙來
选|国家主席
巨|奶|鐵角哈克|乳|屌|骚|槌騎兵|乳俏女醫|乳片|乳俏女医|炮兵團|乳素人|炮兵团|波|騷
裤|袜|衩党|袜女优
引|導|爆|咎辞职|起暴动|发全球退党大潮|导|爆器供应
亡|党|党亡国|共者胡
格|雷(關卡排名管理者)|魯|魯(城鎮移動)|庵遗录
針|孔偷拍
舌|頭穴|尖漫游|头添|头舔|头穴
情|兽|色五月天qvod|獸|色藝術天空|色电影导航|色聊天室|感陪护|妇|色导航|色導航|色妹妹|色艺术天空|色文学|欲|色五月天|色网|色天崖|色五月|色電影|色电影|色文學|色小说下载|色美眉|色成人基地|色|趣用品|色成人論壇|色聊天|婦
馬|克思|良駿|特斯|的|白勺|加爵|大維|三家|時敏|英九|永成
邢|錚|铮
印|尼屠华|尼暴徒|尼伊斯兰祈祷团|尼事件
矫|情纵语
功|友|法|德圆满|学员器官
娘|西皮|比|饿比|的|餓比
施|明德
血|书|渍|腥|洗京城|腥图片|逼
考|试院|后付款|你妈|生名录
冰|毒的制作过程|砖合成|毒的价格|毒买卖|毒製作方法qq|毒制法|毒电话|毒制作工艺|毒供应|毒製作工藝qq|毒供应qq|毒出售|鉆石石配方|zhuan销售qq|磚到货|毒订购|毒配方|毒|粉|磚送货上门|砖到货|磚配方|磚订购|後|毒出售qq|毒出售q|牙签qq|磚销售|毒的制作配方|毒销售|毒配方qq|毒配方出售|毒制作qq|毒制作方法|zhuan出售|砖送货上门|毒配方销售|砖|毒货到付款|磚出货|鉆销售|毒到货|毒出货|du出售|钻订购|钻出货|砖出货|毒销售qq|古批发|毒qq|毒配方讲解光盘|钻石qq|毒送货上门|砖订购|钻到货
賣|國|槍支|合成氯胺酮qq|逼|比|騷|淫|槍支彈藥|假人民幣|氯胺酮付款qq
時|代論壇|事論壇
議|長阿茵斯塔|員斯格文德
嘿|车
带|套肛交
腾|飞科技
宪|政|章|法法院|兵司令部
麻|黄素出售qq|古果子出售|黃素送货上门|黃素订购|黃素出货|古销售|醉乙醚|黄素|谷出货|古的配方|古制作方法qq|醉药|黄素到货|黄素及原料出售|黄素订购|古出售联系方式|黄素原料qq|古供应|谷到货|醉枪|古配方|黄素买卖|古订购|谷销售|因出售|黃素合成方法|黄素送货上门|谷订购|黄素出货|黄素出售|醉槍出售|醉qiang銷售|痹的|古出货|古到货|黃素到货|醉槍销售|果出售|黄素供应|醉枪专卖网|黃素销售|黃素长期供应|黄素qq|黃素配方|古送货上门|醉qiang手槍买卖|醉qiang出售|将|醉枪联系qq|古果子销售|果配方|醉钢枪|果货源量大|黄素配方|醉qiang手qiang买卖|古製作工藝|咕|古电话|古合成|果|黄素销售|谷配方|谷送货上门|醉枪出售|古出售|衣|谷销售qq|古出售qq|古|醉qiang销售|果的制作方法
苯|丙胺|比
冲|击
鋼|珠槍销售|珠槍出售
醬|猪媳
没|磁性|有共铲党
舆|论钳制|论反制
馒|头屄
米|宣教会
凶|杀现场
银|行卡长期出售|民吧|龙岛|行联合管理局|行卡qq|行卡复制器出售|行卡消费问题银联管理中心|行卡买卖|行卡货到付款|行卡供应
讓|你操
仁|波切|吉旺姆
缅|古出售|古qq
成|人视讯|人午夜场|人色情网站|人情色社区|人电视棒|人tv棒|人小电影|人电视棒出售|人a片|人影视|人文學|人激情聊天网|人激情图片|人图片|人动画下载|人a片下载|人u盘电视棒|人交友|人论坛|人游戏下载|人av电影|人激情网址|人性爱用品|人在线电影|人无码|人小說|人av电影在线看|娱色导航|人伦理网站|人激情小说|人av下载|人快播电影|人激情聊天室网站|人动画|人導航|人禁书|人无码dvd|人av网|人电视棒qq|人百强|人性爱|人激情聊天室|人无码a片|人高清bt|人视频下载|人av|人黄站|人无码区|人|人網站|人情色网站|人资源|人软件|人免费性交电影|人小说|人高清电视棒|人视频聊天|人网站导航|人小说下载|人图|人av无码|人电影bt下载|人激情电影|人社區|人a片在线观看|人在线短片|人文学|人av无码qq|人版高清电视棒|人下载|人网站|人仿真抽插|人种子资源|人游戏|人五月天|人裸聊|人电视棒破解版|人动漫bt|人专用播放器|人电影|人圖片|人社区|都军区|人自拍|人网址导航|人熟女乱伦电影|人全裸艳照|人bt|人光碟|人av大片|人片|人电影下载|人dvd|人电视棒销售|人区|人百強|人动温|人电影网站|人暴露色图|人色情|人裸聊聊天室|人导航|人电视棒供应|人午夜性交|人漫画|人論壇|人性社区|人高清电影|人聊天室|人用品|人情色|人遊戲|人激情网站|人短片|人qvod|人色情图片|人黄色网站|人书库|人午夜場
聚|色导航
肮|脏美学
轮|公|功|回|大|工|奸|暴|操|子功|法功|盘赌|奸内射|攻
资|本主义
搶|劫|糧記
肉|莖|體|獅|茎|棍|感炮友|壁|溝|根|击|蒲團|絲褲襪|棍幹騷婦|逼|壶|核|簫|縫|体交融|棒|穴|榜|圈|丝裤袜|箫|狮|门|棍干骚妇|淫器吞精|臀|芽|屄|唇|洞|具|缝|体|丘|蒲团|便器|欲|棍子|欲乐园|沟|壺
臧|人|独
檢|察院
敌|对分子
身|份证代办qq|份证qq|份证号码生成器|份生成器|寸米青|份证办证电话|份证货到付款|份证出售|份證生成器
知|道64
鸦|片渣|片|片液
深|喉服务|喉射精|爱色色|田涼子|愛色色
正|法|品警用手铐|规税票代开|品军刺专卖|品军刀销售网|品m9军刀专卖|見網|義黨論壇|念|规税票代开qq|版成人电视棒|义党论坛|品电视棒qq|规企业代开发票|品八一军刺|品军刀户外刀具|信|府|见网|邪大决战|品电视棒电话
麥|角酸订购|角酸到货|角酸销售|克斯|角酸送货上门|角酸配方|角酸出货
蘇|特勤|特勤護衛兵|特勤魔法師|盈貴|家屯|拉|紹智|特勒守護兵|貞昌|菲爾|南成|曉康
协|警
耻|辱轮奸
街|頭扒衣|头扒衣|头对抗
丹|增嘉措
魂|匣许愿|匣抽
侬|着卵抛|着冈峦
贩|卖摇头丸|卖king粉|毒|卖毒品
比|水|样|樣|毛|比|卵
鐘|山風雨論壇
农|运|业部|夫导航|夫导航最新地址
小|b|姐援交服务|冰砖qq|姐电视台|姐兼职上门|姐全套包夜qq|口徑步槍出售|xue|口径步枪专卖|参考|昭寺|口径步枪价格|口径步槍子弹出售|妹特殊服务|冰磚配方|嫩鸡|便|姐出台服务|冰砖配方|比樣|森美王|冰砖合成|鸡鸡|乳头|姐性息大全|口径运动步枪专卖|冰磚送货上门|口径步枪结构图|冰磚到货|穴|泉純一郎|姐上門包夜|冰磚订购|口径手枪步枪专卖|口径步枪手枪专卖|灵通|姐打飛機|姐包吹包做qq|口径手qiang专卖|姐|b樣|姐上门兼职|口径步槍子弹专卖|口径步qiang专卖|姐按摩服务信息|口径手枪专卖|洞|冰砖订购|日本|雞雞|妹出台|姐保健上门|口径步枪销售|弟弟|电影|口徑步槍销售|肉粒|姐包夜服务qq|冰磚销售|姐兼职|姐全套信息|口径运动步槍出售|口径步枪到货|鶏鶏|澤園|姐性息|口径运动步枪出售|口径步枪出售|妹裸聊|口径步槍子弹销售|泽玛莉亚|嫩雞|姐性息服务|泉|姐援交信息|冰砖到货|冰磚出货|六改火|姐打飞机|阳|犬蠢一狼|口径步枪出货|逼|靈通|口径步枪电话|口径步枪|泽一郎|泉纯一郎|口径运动步槍专卖|冰砖出货|口径步枪订购|口径步枪qq|bi崽子|姐威客|肉穴|口径步枪制造|口径步枪图纸|jj|b样|姐一夜情服务|口径运动步枪销售|姐裸聊|口径步枪专卖网|姐出台包夜|泽圆|姐出台qq|參考|泽园|鬼子|比样|姨子穴|bi|冰砖出售|屄
极|品奶妹|品黑丝|品性虐待|品诱惑|品留学生|端武力直销网|品波霸|品波神|品白虎|品|景|乐岛|品色医全文阅读
鄧|笑貧|小平
贰|拾年|拾周年
充|气娃娃|当涉毒场所保护伞
争|鸣杂志|鸣论坛
歇|逼
惹|火自拍|火身材
風|騷欲女|騷淫蕩|雨神州|雨神州論壇|花|水|豔閣
絲|襪寫真|襪淫婦|襪足交|襪高跟|襪|誘
邮|政局
溴|化铯供应
沈|智慧|彤|跃跃|阳军区|富雄
耀|邦
流|氓|氓燕的日记|淫|蜜汁|血|氓政府|氓警察|血冲突
浴|室干骚女系列|室自拍|室乱伦|尿|室亂倫
防|卫刀具军品网|身刀具专卖|身手枪qq|身电警棒出售|身麻醉枪出售|身武器订购|身器材专卖|衛指揮官|身电警棍专卖网|身武器制造图|身弓努专卖|卫刀具直销网|身警用电棒出售|身警用电击棒出售|身电警棒供应|卫著名军刀出售|卫指挥官|身电警棍专卖|身警用电棍出售|身警用装备出售|身武器电话
企|转组[2006]1号文件|业军转干部
最|新欧美无码|新假钞|新版手机监听软件|淫官员|新日本无码|新股民资源|快报码室|新假币销售|新业主名录|新素人av|新有码|新东京热下载|新手机卧底软件|新东京热全集|新版假钞批发|新无码|新车主资料供应|新一本道|新假币出售|新版假幣|新东京热种子|新熟女|新一本道种子|新1000人斩|新一手股民资料供应|新证券新资料供应|新成人视频下载|新汽车解码器|新版假人民幣|新黄站|新东京热无码|新一本道电影下载|新亚洲无码合集|新汽车万能解码器|好的网上真人赌博|新版假人民币|新版假人民币销售|新一本道无码
運|營長|營|營人|營商|營官|營組|營者
贾|庆林|甲|廷安|育台
册|那娘餓比|老|那娘比|那娘饿比
襲|近平
k|粉买卖|kk.xaoh.cn|anzhongguo.com|粉电话|粉的价格|artt.cn|etamine|粉製作|粉qq|粉专卖|粉制作|o180|粉配方|ing粉送货上门|粉送货上门|efu|粉低价出售|粉摇头丸出售|粉到货|粉|elindun|od920.cn|ang4议l法l轮l功minghui.org|asiteluo|ing粉合成|ing粉到货|ing粉订购|粉出售|粉价格|ao|issmyass|他命|粉订购|粉货到付款|粉制造过程|粉出货|粉的制作方法|粉合成|ing粉配方|ing粉出货|ing粉销售|粉销售
钢|珠弓弩专卖网|珠枪|珠弹专卖qq|珠枪qq|珠弓弩专卖店|珠弓弩|珠弹求购|珠弩热卖|珠弩送货上门|珠枪火药动力|珠狗到货|珠枪销售|珠子弹|珠狗|珠枪买卖|珠54手枪结构图|珠狗供應|珠狗出售|珠猎狗出售|珠槍出售
香|港赛马会六合网|港赛马会大型六合彩资讯网|港6合彩|烟迷药|水型迷奸药|港六合彩资料|港明报|港六合彩公司|港和港通的组合|港六合彩公司特码|港民主派|港彩宝必中六肖|茗慕风流阁|港开奖|港赛马会|港黄大仙|港沈氏公司|港和电话的组合|港内幕|港三级色情片迅雷下载|港无码电影|港三中三|港六合彩一码中特|港中特网管家婆|港彩票|港总彩|港白小姐|港六星合彩|港六合彩|港藏春阁|港特别行政区政府行政长官|港马会|港曾道人|港惠泽社群|港6合彩公司
转|法轮|世|法|化论|膛枪|化|化书|法论|让开锁工具
包|射视频|养情妇|胡|赢|爽包射|夜打炮|二奶|皮|pi
夜|店小姐|总会招聘|激情|勤病栋|情|诱娘子|场兼职|场招聘|场直招|总会|總會|店兼职女郎|淫|色贵族|总会公关|话紫禁城|店小姐特殊服务|情成人|話紫禁城|场女模特|总会模特
娄|义
产|党共|权局
製|作炸藥|作氯胺酮qq|作炸藥qq|造緬古合成
瓜|娃子
计|生委|牌软件
跳|大神|蛋
开|房自拍|增值税专用发票|发票联系|国大典|周天秘法|增值税发票|咨询发票|发票公司|锁工具货到付款|锁工具批发|锁工具出售|锁器材专卖|天目|建筑发票qq|山刀出售qq|房视频|苞|放杂志|建筑发票|锁工具专卖|锁工具买卖|锁王|苞价格|山刀专卖qq|房|锁器|心五月天
釣|魚島
謝|長廷|深山|選駿|中之
習|主席|大大|近平|遠平
整|肃官场
猎|枪制造图纸|qiang出售|枪网|枪仿真枪qq|qiang子弹出售|枪qq|豹弓弩出售|刀军品出售|豹小手弩|刀买卖|qiang子弹提供qq|枪子弹专卖网|枪子弹出售|槍出售|qiang子弹订购|枪子弹提供|枪子弹供应|刀销售qq|艳江湖梦txt全集|枪老牌网站|枪结构图|枪出货|枪订购|刀专卖|枪提供霰弹|枪子弹供应qq|枪子弹销售|枪到货|刀专卖qq|狗出售|枪子弹订购qq|qiang子弹提供|枪电话|枪出售qq|qiang子弹供应qq|qiang子弹电话|qiang子弹销售|枪论坛|qiang子弹供应|qiang货到付款|qiang销售|艳天下下载|枪霰弹专卖|枪子弹提供qq|槍销售
婊|子|子養的|zi|子养的
野|營軍刀专卖|營手斧专卖|营军刀网|营刀具专卖|营刀具军品网|外性愛|合|营军刀出售qq|营生存刀qq|外性交|鶏|外军刀专卖
嫐|屄
碘|化汞供应
钥|匙解码器
酱|猪媳
法|**侖|@@伦|@@轮|^^論|论|(轮)功|*掄|@@沦|@@淪|~~轮|抡|$輪|@@纶|轮功修炼者|謫功|纶|轮功学员|@仑|~掄|輪大法|$$仑|$$論|@@掄|@沦|^掄|仑|轮大法好|$倫|~抡|杖|功|lun功|$$倫|$轮|~~纶|~倫|**綸|@@論|@抡|会|~~沦|~~輪|.轮.功|$$轮|$掄|^^綸|~纶|侖|輪功|囵|愣|0功|西斯|@@綸|^侖|轮|^轮|$伦|$纶|@輪|^^仑|^^侖|~~倫|~輪|沦|谪功|一轮一大一法|$论|*侖|^^轮|^沦|謫|~~侖|^论|$淪|*綸|^^輪|~~淪|尔卡|克鱿|$抡|綸|谪|\*功|@@仑|^^掄|^^沦|爾卡|$$沦|$$纶|$$论|@@輪|^^论|轮功真|@倫|^纶|^綸|轮功学|图麦|$沦|@伦|^伦|^輪|~~伦|掄功|$$綸|@綸|@論|~~綸|轮功三去|^^纶|^抡|~~论|~轮|~论|$綸|**掄|@@倫|^^抡|~~抡|~~掄|$$掄|制办|@@抡|@纶|lg|伦|$$輪|$仑|@@论|~論|@掄|@论|^^倫|o功|@@侖|~仑|掄|~綸|轮功弟子|$$伦|$$淪|@轮|^仑|~侖|~淪|\u8f2a|$侖|^^淪|~沦|倫|淪|論|轮圣王|$$抡|^論|轮功|轮尊圣|一轮一功|$論|^倫|~~仑|~~論|轮大法|正乾坤|@淪|论功|輪|x功|lun|十輪十功|@侖|^^伦|^淪|~伦|$$侖
嗑|药|藥
鸡|毛信文汇|芭|掰|奸|吧|蛋|把|八|女|院|ｙ|８|巴暴胀|巴|叭|y
裏|菲斯
团|派人马|派政治明星|派
亦|凡
帐|号
张|钢|宏堡|三是个坏蛋|高丽；毛泽东|清芳|万年|丕林|定发|明双|立昌|筱雨|志新|春贤|潮阳|博雅|春桥|健|伟国|志国|昭富|小平|朝阳|德江|荣坤|三是帅哥|博涵|培莉|志清|开双腿|磊|温鹰|高丽|林|五常|伯笠|阳德
支|那|持zd
揭|批书|批書
气|枪专卖商城|枪看货加qq|槍专卖|枪钢珠枪专卖|gou专卖qq|猎货到付款|槍买卖|枪买卖|枪联系qq|枪出售|功|动枪|枪订购|枪网|动钢珠枪购买|狗销售网|枪销售网|gun专卖|狗销售qq|狗狗粮|狗粮出售|枪专卖qq|狗配件出售|象局|狗qq|槍出售|枪指定销售|枪专卖店|枪子弹专卖店|枪销售|gou专卖|狗销售|枪购买|狗专卖店|槍购买|枪专卖
唐|捷|嘉爵|人电视台|山大地震老伤兵|家璿|刀专卖网|家璇|柏橋|子|柏桥
导|弹
宇|明网|宙众生|宙大法|宙的大法|峻|峻奥汀|峻奧汀|明網
医|师资格证办理|疗发票代开|院聘民警当副院长防医闹|生
右|派
爱|他死|国者同盟|上少妇小镇情人|护与救度|图公园|幼阁|妻淫穴|滋|就操成人网|与性-一个大学女老师的自述|女人|色cc|液|液横流|上师娘的床全文
堪|布
桜|井|田
侵|害业主正当权益
伺|服器
管|理员|裡|理員|碧玲|理|里|.理.员|_理_员|'理'员
程|真|铁军|凱|鐵軍|凯
宮|下杏奈
撕|逼
濫|b|逼|比|貨|交
勤|司领部
剛|比樣子|比
蠢|猪
娇|艳江湖|宠水芙蓉|艳人生
江|昏君|浙民|八點|某某|泽慧|责民|core|泽民政府|择民|x|湖淫娘|zm|则民|绵恒|贼|流氓|浙闽|家中央|賊|家帮|豬媳|鬼|派|系|端仪|羅|氏|书记|核心|蛤蟆|猪媳|二世|贼民|八|胡|沢民|独裁|賊民|哥|民|澤泯|綿恒|主席|猪|罗|折民|绵康|氏集团|八点|澤慧|戏子|澤民|戲子|魔头|ze民|泽民|則民|青
伪|火|币出售
拔|屄自拍|屄|出來|出来
邪|恶|恶的党|教本质|惡|教|党中央邪党专制邪党组织邪恶|党|魔|恶活动|恶江泽民
当|代八乱|局严密封锁
窒|息邪恶
雄|烯二醇
懒|叫|教
發|*掄|掄功|$$論|$掄|$侖|@@淪|@@論|楞|^論|~倫|~論|淪|正念|$倫|$論|*綸|^^倫|^侖|^淪|倫|~侖|票|^輪|@輪|^^淪|^綸|綸|@@綸|$$輪|@侖|侖|掄|$$掄|$$倫|$淪|@@侖|^倫|~~掄|~~淪|騷|$$淪|*侖|@@輪|^^輪|~~論|剽代開|$$侖|@@倫|~綸|倫功|~~倫|~~綸|**綸|@倫|^^掄|~~輪|~輪|@掄|@@掄|@綸|^^侖|~~侖|~淪|論功|浪|@淪|輪|@論|^掄|缥|$$綸|$輪|**掄|**侖|^^綸|^^論|論|$綸|~掄|論公
沌|决
士|兵管理員瓦爾臣
办|理假冒1代身份证|理壹代假冒身份證|理大专文凭|理真文凭|理2代假冒身份證|理假1代身份證|理假身份证|理各种|理凭文|理国外文凭|理假二代身份證|理個人2代身份證|理真实壹代身份證|学位证|理真一代身份证|理个人1代身份證|理毕业证书|假结婚证|理2代假冒身份证|理各种毕业证|理假冒1代身份證|理假香港身份证|证当面交易|理2代假身份證|头目|毕业证找qq|理真一代身份證|理假证刻章|理行驶证|证公司电话|理假户口办|理个人一代身份证|理假冒二代身份证|理一代個人身份證|大学毕业证|大学毕业证书|理自考本科文凭|理二代精仿身份证|理一代高仿身份证|理证件qq|离婚证|理二代精仿身份證|理1代精仿身份證|证qq|理会计师证qq|理壹代假身份證|理真实二代身份证|证刻章|证服务qq|高中毕业证|真实文凭|理各种证件|理证件|理假结婚证|理真实1代身份证|理各类操作证|理個人一代身份證|理二代高仿身份證|理真壹代身份證|理警察证|假学历|理证件货到付款|假毕业证|理真壹代身份证|职称证|理学生证|理个人壹代身份证|真学历|理假2代身份证|证公司qq|理2代精仿身份证|理假文凭qq|理专业四级证书|理各类证件|理个人1代身份证|理执业医师资格证|理个人2代身份證|理学位证书|证服务电话|理假毕业证|假毕业证qq|理假一代身份证|理个人二代身份證|假証|假学历qq|四六级证|理网上认证文凭|理假冒二代身份證|理一代精仿身份證|理假冒壹代身份證|理个人壹代身份證|理個人壹代身份證|理医师资格证|理2代精仿身份證|理一代精仿身份证|理個人二代身份证|证刻章有限公司|理假户口本|理自考证书|理真1代身份證|理真实1代身份證|学历证件qq|理各种防伪身份证|军官证|理假房产证|理真1代身份证|理個人二代身份證|理假冒一代身份證|假二代身份证|理假警察证|英语四六级证书|理香港身份证|理假学历证书|统招本科文凭|理户口本|假银行卡|理假冒一代身份证|理假壹代身份证|假身份证|理高等院校毕业证|假英语六级证|理個人1代身份证|理个人二代身份证|理假1代身份证|理国安证|理一代假身份證|假证qq|理真实壹代身份证|理1代精仿身份证|理假冒壹代身份证|律师执业证|理壹代高仿身份證|理2代個人身份證|理国外证书|理真2代身份证|理2代高仿身份证|理各类资格证|理个人2代身份证|理1代假冒身份證|理毕业证|理假一代身份證|理假冒2代身份證|警官证|理英语四级证书|理资格证|假户口本|理计算机等级证书|理假离婚证|理1代高仿身份证|理会计证|理真2代身份證|理文凭|理真二代身份证|理假身份證|证刻章公司|本科文凭|理二代高仿身份证|理個人1代身份證|理壹代個人身份證|理离婚证|理真实2代身份证|理壹代假冒身份证|真文凭|理教师资格证qq|理军官证|理假冒身份證|理一代假冒身份證|理1代假身份證|理真身份证|理真实身份证|理个人一代身份證|证|理军官证qq|假证件|理大学学历证书|理假壹代身份證|理假二代身份证|假证|假驾驶证qq|警官证电话|理国外学历证书|各院校毕业文凭|理壹代精仿身份证|假驾照qq|理真身份證|假驾照|警察证qq|理假2代身份證|理假证件|假身份证qq|理二代假冒身份證|理2代高仿身份證|驾照|理個人2代身份证|理1代個人身份證|警察证|理一代高仿身份證|假房产证|理警官证|假导游证|理真实一代身份证|证服务公司|理假冒2代身份证|理個人一代身份证|理1代高仿身份證|证电话|证公司网|真毕业证|英语六级证|证中心|理真凭文|理假冒身份证|理律师证|理真二代身份證|理统考证书|理各种文凭|理二代個人身份證|理壹代高仿身份证|理二代假身份證|理真实一代身份證|理真毕业证|假英语四级证|理假护照
震|动棒|惊全球
房|事
姦|淫|染|情|淫電車
y|ujiankang|s168.com|aokong7.com|in道|alishanda|aowenyuan|indi|户|isilan|uyongkang|inlongisland|ouxing|蒂|eswm.com|uzhengsheng|ouxiji888.cn|in部|in毛|umuming|uming|z55.cn|in荡|ou行|inshui|idangzhuanzheng|ejianying|茎
輕|舟快訊
4|事件|-jun|号白粉出售|5mm狗粮现货|5mm狗粮专卖|5mm狗粮图纸|7513.cn|5mm狗粮制造|5mm狗粮出货|5mm狗粮出售|5mm狗粮|点20叫醒我|5mm狗粮订购|5mm狗粮电话|5mm铅弹出售|5mm狗粮连锁|5mm狗粮货到付款|5mm狗粮预订|风|.25|5mm狗粮到货|5mm狗粮售出|5mm狗粮qq
間|苯三酚送货上门|苯三酚配方|苯三酚出货|苯三酚订购|苯三酚到货|苯三酚销售
由|喜贵|喜貴
啊|無卵|无卵
是|鸡|你妈|你爹
吊|靴鬼|子
梅|毒|花网|德韋傑夫|德韦杰夫|花屄
秦|氏弓弩专卖|氏弓弩专营|晋|逊辉|慧珠|氏弓弩专供
澳|洲光明网|门特别行政区政府立法会
生|殖|孩子沒屁眼|命分流的圖騰|奸|者和死者|徒胸觸|命分流的图腾|徒胸触|奸内射|姦|鸦片|奸內射
工|字气枪专卖网|字牌氣槍销售|字牌气枪销售|字牌汽枪图纸|商税务两条狼|字牌汽枪出售|自聯|字气枪专卖|字牌气枪出售|业炸药配方设计|业硝酸铵供应|字气枪销售|字牌氣枪提供|字牌氣槍qq|字牌汽枪到货|字牌汽枪qq|字气枪网|蜂六型多管火箭系统|商代理qq|字气枪出售|字牌气枪指定销售点|自联|字牌气枪结构图|字牌汽槍出售|产党|字牌汽枪制造|字牌汽枪电话|运|字牌氣槍出售|字牌汽枪出货|字牌汽枪订购|字牌气狗
8|9-64cdjp|188mu.com|9事件|9学潮|仙|8kx.com|9学运|341部队|9年春夏之交|8mysf.com|9民运|1軍刺专卖|88895.com|9运动|023部队|的平方事件
教|育部|你做炸药|養院|徒|养院
p|engliyuan|cp气枪专卖网|pk销售|眼|enis|cp气枪分解图纸|pk出售|k200.com|rettyirene.net|eacehall.com|ai9|pt.cc|layboy|cp专卖|aper64|eacehall|kmmo.com|cp配件|ujing|cikchina.com|huc|orn|engdehuai|ussy|arke888.com|x|cp新贵出售|etgirl
票|优惠联系|据代开qq|据|源正规
辅|助程序
初|夜访谈
無|碼電影|幫過|碼做愛|碼無套|碼h漫|界瀏覽器|邦國|套自拍|碼淫漫|碼精選|碼絲襪|碼長片|毛穴|碼光碟|碼|套內射|碼淫女|碼炮圖|毛美少女|修正|幫國|碼彩圖|碼體驗
坐|台|交|莊|台的|台小姐兼职|庄
陸|委會
扎|卡维是英雄|卡維是英雄|瓦赫里|卡维
港|密传|澳办|台成人|独|科|内料|独；|彩|料|内绝密
啦|撒|沙|萨
后|宫|穴|庭专区|庭诱惑|庭
b|ulaier|enladeng|aopi|样|bs.7gg.cn|痒|lowjobs|aichi|oxun|bs.766.com|z176.com|好痒|ao皮|astard|i样|lowjob|aozha|aodong|t成人|bc中文网|bs.butcn.com|oxilai|aoweier|anchan|c|iaozi|ignews|aijie.1249.net.cn|bs.pkmmo|ibidu.com|wowd.com|enzodiazepines|a课|jork|oycott|itch|cd.s.59764.com|ulaoge.com|loodisonthesquare|aoluan|bc.co.uk|iao子|obaoping|穴|ushi|lacksee.com.cn|l62.com|azhuwg.cn|ao炸
魅|惑巨乳|夜帝国
慰|春情|安妇|安婦
颠|覆|倒国家|覆国家政权
调|教|教虐待|情|理劳物系
豪|乳
l|2jsom.cn|ordren.com|idashi|ikeko.com|igen|uyi|unlidianying.1274.net.cn|qb362订购|ingjihua|uogan|iushaoqi|iusi|uoronghuan|aola|aichangxing|yx-game.cn|iruihuan|ichangchun|uoxialu.cn|ybbs.info|ibertytimes.com.tw|qb362出货|inken|ianzhan|iening|iuhecai|ilanqing|iuqi|uxiulian|unlidianyingxiazai.1174.net.cn|ihongzhi|ianggezhongguo|iulijun|inbiao|iubocheng|idenghui|ll.xaoh.cn|xsm888.com|iuyunshan|ipeng|angyou.info|amusifeierde|a萨|qb362电话|qb362到货|ikeqiang|idazhao
廣|聞|電局|州三箭氣出售
講|法
經|文|血|典炮圖
甘|丹寺
班|禪|禪丌|禅
春|药|夏自由论坛|宫图|夏自由論壇|光外泻|藥|光外瀉|季守護靈|色激情网|欲手|宫|宵|菜|季守护灵
欢|欢娱乐时空|乐性今宵|乐谷导航
愛|圖公園|液橫流|色cc|滋|女人|幼閣|妻淫穴|滋病|内萌|液
硫|酸铊批发|酸铊销售|酸铊銷售|酸铊专卖
猫|肉|则东|泽东|贼洞
調|教|教虐待
汤|光中|加丽
朝|天穴|鮮|河兰|河蘭|鲜|鲜版假钞买卖|鲜版人民币批发
相|奸
誘|惑視頻|色uu
提|供冰毒|供易容人皮qq|供高仿脸皮qq|供三箭牌汽枪|供k粉|供胸推服务|供92手枪|供乳胶人皮qq|供高仿面皮qq|供猎枪子弹qq|供单管猎枪|供麻醉枪|供猎枪|供肾源qq|供港38式左轮枪|供人造面皮qq|供美化面具qq|供易容脸皮qq|供人造脸皮qq|供猎qiang子弹qq|供仿真气枪|供54手枪子弹qq|供美女裸聊服务|供步qiang|供手槍|供54式|供54手qiang子彈qq|供64手qiang子彈|供散弹狗|供仿真人皮qq|供乳胶脸皮qq|供64手qiang子彈qq|供工字牌汽槍|供袖珍手枪|供92手qiang|供猎枪子弹|供正品军刺|供54手槍子彈qq|供猎枪霰弹|供健衛小口徑|供军用刀具|供獵槍麻醉槍|供制作麻古原料|供麻黄碱|供肾源|供工字牌氣槍|供92手qiang子弹qq|供54手枪子弹|供虎头双管|供瓦斯手狗|供口交服务|供溫切斯特1000x|供美国秃鹰|供獵槍子彈qq|供手qiang子弹|供小姐|供麻醉qiang|供92式|供单管半自动猎枪|供仿真来复枪|供股民数据|供禿鷹汽槍|供92手槍|供高仿人皮qq|供54手qiang子弹qq|供92手枪子弹qq|供钢珠狗|供司马系列气狗|供qi狗|供64手qiang子弹qq|供64手qiang子弹|供仿真枪模|供广州三箭|供仿真枪|供92式手槍|供手槍子彈qq|供獵槍子彈|供三箭气枪|供人皮面具|供半成品冰毒|供自用电狗|供乙醚|供海豹m9|供钢珠猎狗|供双管平式枪|供獵qiang子彈|供54手槍子彈|供45mm狗粮|供高仿真人皮qq|供仿真面具qq|供十字开锁器qq|供cfx气枪|供进口硅胶脸皮qq|供64式|供广州三箭气枪|供硅胶脸皮qq|供手槍子彈|供收藏数据|供专业开锁工具|供fx气皇|供硅胶人皮qq|供易容面皮qq|供仿真面皮qq|供小口径步枪|供娥眉气枪|供ppk|供乳胶面皮qq|供好吗|供二代身份证|供77手qiang子彈qq|供军用手枪|供乳交|供冰鉆石教程|供自制式64式|供步qiang子彈|供打手|供高仿真面具qq|供步槍子彈|供金钟气枪|供手枪子弹qq|供进口硅胶面具qq|供高仿真面皮qq|供步qiang子彈qq|供54手狗子弹|供92手qiang子弹|供高压气枪|供打飞机|供警用手铐|供廣州三箭氣|供仿cz75bd手枪|供乳胶面具qq|供进口硅胶面皮qq|供氯胺酮|供k粉qq|供64式手枪|供人皮面具qq|供獵qiang子彈qq|供步枪子弹qq|供92手qiang子彈|供手狗|供64式手槍|供77手槍子彈qq|供各种锁匠器材|供m92f式手槍|供92手槍子彈qq|供92手枪子弹|供64手槍子彈|供德国a1000|供散弹枪|供步槍子彈qq|供电购数据|供专业打手|供高压狗|供散弹槍|供猎qiang子弹|供台湾秃鹰|供股民数据qq|供工字牌汽枪|供左轮钢珠狗|供自製手狗|供子弹|供步qiang子弹|供手qiang子彈|供秃鹰|供獵槍|供77手枪子弹qq|供77手qiang子弹qq|供步枪子弹|供92手槍子彈|供立式双管猎枪|供獵槍手槍|供高仿真脸皮qq|供防身麻醉枪|供獵狗|供硅胶面具qq|供手枪子弹|供汽狗|供肛交服务|供仿真脸皮qq|供lqb362|供步槍|供健卫小口径|供步qiang子弹qq|供高仿真人皮面具qq|供高仿真人皮面具|供足交服务|供手机变号软件|供盐酸羟亚胺|供摇头丸|供港38式左轮|供溫切斯特|供英国骚本气枪|供虎頭獵槍|供猎狗|供54手qiang子彈|供仿真狙击枪|供易容面具qq|供手qiang子彈qq|供54式64式|供铅弹气枪|供健卫步枪|供64手枪子弹qq|供64手枪子弹|供出售双管猎枪|供高仿面具qq|供手qiang子弹qq|供鉛彈氣槍|供pcp新贵|供硅胶面皮qq|供进口气枪|供54手qiang子弹|供开锁器|供广州三箭气|供92手qiang子彈qq|供64手槍子彈qq|供左轮手枪|供虎头猎枪|供黄牙签|供俄罗斯654k|供高壓氣槍|供92式手枪|供仿真槍模|供进口硅胶人皮qq|供鹰枪货源|供秃鹰汽枪
淫|书|媚|毛|婦自慰|奸电影|情|亵|照|色导航|魔舞会|情女教师|賤|亂工作|流|糜|水四濺|蕩貴婦|僧|男|妇|肉诱惑|乱诊所|东方|教师|妻交換|色影院|人堂最新地址|洞|荡|水爱液|兽学园|痴|师荡母|靡|荡有声小说|道|棍|影|图|婦|水絲襪|播网|蕩少婦|影片|阴|术炼金士|書|荡肛交妹自慰器|奸|亂|b|液|声浪语|水丝袜|和尚社区|姐姐|色阁成人|图下载|间道|水涟涟|告白|逼|獸學園|蕩|亂潮吹|虫|女炮图|乱|色阁|情贴图|秽|水|水四溅|荡迷情药|戰群p|荡自慰器|蕩丗家|乱电影|兽|妇自慰|电影|穴|乱工作|水翻騰|色貼圖|贴图|店|穢|圖|驢屯|色网站|家|荡贵妇|浪|色妹妹导航|色基地|妇口交|欲世家|虐|母|妞|亂診所|水橫溢|色电影|人阁播放器|贱|民|癡|水漣漣|影院|娘|欲日本|战群p|欲|秽小说在线阅读|丝荡袜|河|姐|色贴图|師蕩母|声|臀|叫|東方|水愛液|暴|蕩孕婦|汁|妻交换|腔|荡口交妹|妹|蜜|奴|娃|唇|浆|妻|の方程式|水横流|货|片|色|水橫流|肉誘惑|声系列|色阁成人电影|乱熟女|语连连|樣|漿|蟲|乱俱乐部|魔都市|乱电影下载|美贴图|魔|驴屯|貨|亂熟女|荡文学|屄|水横溢|絲蕩襪|聲浪語|秽词语|女|样|女炮圖|传
看|中國|牌软件|中国
世|界经济导报|界维吾尔代表大会|界經濟導報|界以利亚福音宣教会|维会|界日报|界开运动功
禦|の二代目
兜|比
一|肖|品色导航|夜情激情成人聊天室|带一路|边一国|夜欢|夜性网|国两制|般炸药制作|个身份|夜情服务qq|本道qvod|贯道|夜歡|夜情視訊聊天室|本道迅雷下载区|黨|元硬币货到付款|夜情交友聊天室|夜情成人论坛|党|黨專政|起看a片|码中特提前|代高仿身份证|元化|夜|夜色妻|夜性網|夜情交友网|夜情交友俱乐部|貫道|切证件|码中特|中一台|陀粪|手老人数据|本道高清无码|夜情交友|本道电影|本道无码合集|军两策|代精仿身份证|代個人身份证|党专制|本道视频|对一裸聊|本道|党执政|字解特码|夜情论坛|党专政|夜情上门服务|品楼vip高级帐号|夜情俱乐部|陀糞|夜情性息|邊一國|元假钱出售|夜情|夜九次郎|代假冒身份证|党独裁|ye情
体|位|奸|制－中长期科技规划
尤|比亞|比亚|特
器|官移植
灌|满精液|滿精液|肠自慰器
换|妻大会|妻杂交|妻|妻俱乐部
噴|精|你
底|制|裤
虎|头双管到货|头双管电话|头牌猎狗专卖|头牌双管猎枪专卖|头牌猎槍出售|头牌五连发猎枪出售|头牌双管出售|头猎枪qq|头双管订购|头牌双管猎枪出售|頭獵槍出售|头五连发猎槍出售|头双管制造|头猎枪制造|头双管qq|头双管出货|头牌双管猎枪销售|头双管出售|头牌单管猎枪出售|头猎枪销售|騎|头猎枪订购|头猎枪到货|骑成人网|头牌猎枪出售|头猎枪出售|头猎枪图纸|骑|门|頭獵槍制造图|头牌单管猎枪专卖|头猎枪电话|头牌猎枪销售|头牌猎枪专卖|頭獵槍销售|头牌猎槍销售|头牌五连发猎枪专卖|头猎枪出货|头双管图纸
鲜|族
本|拉登|期6合彩开奖结果|土無碼|土无码|公司代办|?拉登|科文凭qq|科文凭办理|屌
骚|母|妹|妇掰b|b|乳|妈|货|浪美女|棒|浪|穴|穴怒放|妇露逼|鸡|卵|比|姨妈|姐姐|妹妹|b熟女|屄|女叫春|逼|包|姊姊|女|妻|洞|棍|本气狗专卖|痒|水|浪人妻|本气枪出售|婊
住|宿发票代开
榊|彩弥
共|黨|榮圈|青团|产|惨|产主义道德教育|産|chan党|產主義|产主义的幽灵|荣圈|c党|残主义|一产一党|和国之怒|贪党|産黨|産主義|和|残党|产主义|产王朝|产革命|匪|铲|x党|產黨|軍|党|奴|狗|惨党|残裆|产专制|产邪党|产党|产党下台|铲党|军
子|宮|弹|弹制|女任职名单|弹专营|弹专卖|弹出售|宫
雷|管炸药看货付款|明顿出售|明顿销售|管|根|管製造|管当面交易|管qq|豹气狗基地|鸣登猎枪出售|尼亞|菲娜|管供应|管看货付款|管的制作方法|管製造技術qq|明頓出售|明頓銷售|汞|尼亚|倩
殃|视
盘|古乐队|口|古
到|市政府请愿
豬|操|毛
犯|罪替人说情
装|逼|b|屄|13
思|科羅|潮|科罗
从|传统人制到竞争优胜
氫|彈
跨|世纪的良心犯|下呻吟
方|勵之|励之|寿伟|舟子
鄺|錦文
張|清芳|高麗|伯笠|鋼|春橋|筱雨|立昌|萬年|林|德江|志清|五常|博雅|溫鷹|昭富|丕林|宏堡|健|偉國
未|滿18|成年者|来震源|满18
鉆|石冰出货|石冰订购|石销售|石冰销售|石冰出售
铀
屄
肏
屌
婊
屌
婊
屌
操
淫
尻
贱
腚
娼
肏
屄
妈
爸
爹
爷
奶
&
ㄅ
ㄆ
ㄇ
ㄈ
ㄉ
ㄊ
ㄋ
ㄌ
ㄍ
ㄎ
ㄏ
ㄐ
ㄑ
ㄒ
ㄓ
ㄔ
ㄕ
ㄖ
ㄗ
ㄘ
ㄙ
ㄚ
ㄛ
ㄜ
ㄝ
ㄞ
ㄟ
ㄠ
ㄡ
ㄢ
ㄣ
ㄤ
ㄥ
ㄦ
ㄧ
ㄨ
ㄩ
鞴
鐾
瘭
镳
黪
瘥
觇
孱
廛
蒇
冁
羼
螭
傺
瘛
舂
艟
瘳
雠
搋
嘬
辏
殂
汆
爨
榱
毳
皴
蹉
鹾
纛
莪
苊
鲕
鲼
瀵
酆
幞
黻
呒
黼
阝
彀
觏
毂
汩
罟
嘏
鲴
宄
庋
刿
虢
馘
撖
夯
薅
曷
翮
曷
翮
觳
冱
怙
戽
祜
瓠
鹱
溷
耠
锪
劐
蠖
丌
乩
赍
殛
蕺
掎
彐
芰
跽
鲚
葭
恝
湔
搛
鲣
鞯
囝
趼
醮
疖
苣
屦
醵
蠲
桊
鄄
谲
爝
麇
贶
悝
喟
仂
泐
鳓
诔
酹
嫠
黧
蠡
醴
鳢
轹
詈
跞
奁
臁
蚍
埤
罴
鼙
庀
仳
屺
綮
汔
碛
葜
佥
岍
愆
搴
钤
掮
凵
肷
椠
戕
锖
檠
苘
謦
跫
銎
邛
筇
诎
麴
黢
劬
朐
璩
蘧
衢
糁
㎏
㎎
㎜
碡
籀
邾
舳
瘃
躅
翥
颛
丬
隹
窀
倬
斫
诼
髭
鲻
秭
訾
偬
诹
陬
鄹
鲰
躜
缵
阼
祚
垵
嶴
㈧
韝
蹕
颮
鑣
黲
草
覘
蕆
囅
閶
諶
齔
櫬
讖
鴟
輳
鹺
紿
氹
糴
覿
鮞
㈡
鱝
紱
襆
嘸
鯁
緱
覯
轂
鯝
鴰
詿
嬀
劌
緄
鯀
咼
頇
顥
灝
黌
鱟
鸌
鍰
噦
繢
鍃
賫
鱭
戔
鰹
韉
撟
嶠
癤
訐
巹
㈨
齟
屨
棬
譎
闞
緙
瞘
嚳
貺
鰳
誄
鱧
轢
躒
奩
躪
㈥
鷚
輅
鋝
腡
濼
勱
禰
羋
黽
緡
湣
鰵
鯢
儺
蹣
轡
羆
諞
磧
僉
鈐
膁
槧
錆
繰
譙
鞽
篋
唚
檾
詘
闃
犬
綣
愨
顬
㈢
毿
糝
厙
灄
詵
諗
澠
釃
鯴
㈩
鰣
貰
攄
㈣
藪
誶
鰨
闥
鮐
鞀
謄
齠
鰷
銚
摶
鼉
籜
膃
綰
鮪
閿
覡
餼
郤
薟
躚
獫
蜆
峴
鯗
嘵
頊
諼
澩
訁
讞
軺
㈠
瘞
傴
齬
飫
鵒
韞
鏨
賾
譖
驏
㊣
縶
躑
騭
觶
躓
㈱
顓
諑
鯔
諏
鯫
躦
纘
乳
党
叼
奸
妓
姦
嫂
嫖
屄
屌
性
操
淫
穴
肛
裸
铀
骚
干
九
评
真
善
忍
真
善
卵
丬
乩
仂
仳
佥
倬
偬
傴
傺
僉
儺
冁
冱
凵
刿
劌
劐
劬
勱
厙
呒
咼
唚
喟
嘏
嘬
嘵
嘸
噦
嚳
囅
囝
垵
埤
夯
奁
奩
娼
婊
嫠
嬀
孱
宄
尻
屦
屨
屺
岍
峴
嶠
嶴
巹
幞
庀
庋
廛
彀
彐
怙
恝
悝
愆
愨
戔
戕
戽
掎
掮
搋
搛
搴
摶
撖
撟
攄
斫
曷
朐
桊
棬
椠
榱
槧
檠
檾
櫬
殂
殛
毂
毳
毿
氹
汆
汔
汩
泐
混
湔
湣
溷
滚
澠
澩
濼
瀵
灄
灝
爝
爨
獫
璩
瓠
疖
瘃
瘛
瘞
瘥
瘭
瘳
癤
皴
睾
瞘
碛
碡
磧
祚
祜
禰
秭
窀
筇
篋
籀
籜
糁
糝
糴
紱
紿
綣
綮
綰
緄
緙
緡
緱
縶
繢
繰
纘
纛
缵
罟
罴
羆
羋
羼
翥
翮
耠
肏
肷
腚
腡
膁
膃
臁
舂
舳
艟
芰
苊
苘
苣
莪
葜
葭
蒇
蕆
蕺
薅
薟
藪
蘧
虢
蚍
蜆
螭
蠖
蠡
蠲
衢
襆
覘
覡
覯
覿
觇
觏
觳
觶
訁
訐
訾
詈
詘
詵
詿
誄
誶
諏
諑
諗
諞
諶
諼
謄
謦
譎
譖
譙
讖
讞
诔
诹
诼
谲
貰
貺
賤
賫
賾
贱
贶
赍
趼
跞
跫
跽
蹉
蹕
蹣
躅
躑
躒
躓
躚
躜
躦
躪
軺
輅
輳
轂
轡
轢
轹
辏
邛
邾
郤
鄄
鄹
酆
酹
醮
醴
醵
釃
鈐
鈾
銎
銚
鋝
錆
鍃
鍰
鏨
鐾
鑣
钤
锖
锪
镳
閶
閿
闃
闞
闥
阝
阼
陬
隹
雠
靠
鞀
鞯
鞴
鞽
韉
韝
韞
頇
頊
顓
顥
顬
颛
颮
飫
餼
馘
騭
驏
髭
鮐
鮞
鮪
鯀
鯁
鯔
鯗
鯝
鯢
鯫
鯴
鰣
鰨
鰳
鰵
鰷
鰹
鱝
鱟
鱧
鱭
鲕
鲚
鲣
鲰
鲴
鲻
鲼
鳓
鳢
鴟
鴰
鵒
鷚
鸌
鸠
鸡
鸨
鹱
鹺
鹾
麇
麴
黌
黢
黧
黪
黲
黻
黼
黽
鼉
鼙
齔
齟
齠
齬
屄
操
性
淫
枪
操
靠
